<?xml version='1.0' encoding='UTF-8'?>
<board>
				<level>83</level>
				<width>32</width>
				<height>30</height>
				<walls>XXXX......X......X.....X........
XXXX....X.....X..X.X.....X......
XXXXX...XX...XX.X..X..X.......XX
....X..X...X..X.X...X.....XXX..X
....XX.X......X.....XXX...XXXX..
X...X..XXXXXX....X...XX.X.....X.
..X.X.XXXXXX...X...X.......XX...
.XX......X...X....X....X.X..XX..
....XX...X......X...X....XX..X..
..X.XX..XXXXXXX....X..X.XXXX.X..
.....X.............X.XX..X...X..
...X...X.......XXX.....X........
XXXX..XX.......X....XX....X...X.
...X..X........X..X.......X...X.
.X...X..XXXXX...X........X..X...
.......XXX....X..X.......X......
X.....X....X.....X..X...........
X...X....XX..X....X...X.........
..X....X..X.......XXX......XXX..
....XX..X...X.....XX...X.....X..
XX......XXX.....X..X.X....X..X..
X....X...........X...XX.X.X.....
X.......X..X...X..X..X..X...X...
..XXX.X.X...XX.XX....X.....XX..X
......X.X.X....X...X...X.....X..
..........XXXX...X.......XXX.XX.
XXXXXX.XX........XX...XX.X...XX.
X....X........X..X..X......X..X.
..XX.....X.......X.X..X...X...X.
...........XXX...X...XX.....X...</walls>
			</board>