<?xml version='1.0' encoding='UTF-8'?>
<board>
				<level>143</level>
				<width>52</width>
				<height>50</height>
				<walls>XX.......XXXX......X....X.....X..XXXXX.........XX..X
...XX.......X.XX.....XX...XXX.X........X..X....XX...
.XX...X...X...XX..X....XX.......XXX.......X.X.....X.
.XX..XX....X....X....X..X....X........XXX.....X.XX..
...X....XX...XX.X..X.XX.X....X.....X....XX......X..X
XX....X......XX.X....XX.X...X..XX....XX....X...X..XX
....XX...XXX....X.X...X.......XXX.X...X..X...XXX.XXX
.X.....X......XXX...X.XX...XXXXX..XXX.X.....XX......
...XX.......X...XX.......XXXXX...X..X.....XXXX..X...
X.....X.........X..X.XXXXX.......X.....X........X...
..X...X...XX......XX..X.......X..X.......X....X.....
.XX..X..X.X......X..X....XX.X.X..XXXXXX....X....XX..
.XXX.X.XX...X....X.....X....X.XXXXXXXXX.X....X..XXXX
.......XX..XX.X....XXX....XXX......XX...X....X......
XXX.XXXXXX..X.XXX....X.XX..XXXX....XX....X.....XX...
..X.........X...XXXX.......X......XX...X....X.....XX
...X......X..XX..X....X......X.X.....X...XX....XXXXX
.X...XXXX..X...X...X....X..XXX...X....XX.X...X......
.X..XXXXXX...X..X..X....X.......X...X.XX...XXXX..X..
..X..........XX....XX.....XXXX..X.X.X.....X......X.X
X.X.X.....X...XX...X...XXX.....X..X...X......XXX...X
X.....XX....X....X...X..XX..X..X...X..XXXX.X.......X
XX...X...X.XX..X.X..XXX.XXX...X....X.XXX...XX.......
...X.....X...X...X..XXX.........X......X.X....X...X.
.X...XX......X.XXX.........X......X......X.X..XXX...
........X......XX..XX......X...X..X...X.......XXXX..
X...XXX...XXX..XX.XXX........X...XX.......X.X......X
..X..XXX....X.....XXXX....X............X....XX......
...X.X...X....XXXX.....XX.X.X.....X......X.....XX.X.
.X...X...X...XX..X....XX..X...X.......X.....X..X..X.
.X.........X.....XXXX.XX...........XX...X.X..XXX....
...XX.....XX...X..XXX....X.....X...XX.....XX........
X..X..X....X...XX......X.....X...X.X.....XX...X.....
...X.......X........XX.......X..XX...X....X.X....X..
.....X...XXX....XX..X......X..X.....X..XX......X.X..
..X....X..XX..X....X..X.......XX....X..X...XXX...XXX
....X.....XX.....XXX......X........XX....XXX.....XXX
......X...XX.X.X.....X.XX...XXX.X..XX.X.......X..XXX
...XX...X......XX..X.X.XX.....X...XXX.X.XXX.X..XXXXX
.X....XX....X.X....X...X...XX.........X.X...XX......
...X..X..X..X....X.......X.XX....X........X.........
X...XX..XX.X...X...XXXX....XX....X.....X.........XXX
..X..X...X...X......XX..X...X.....X......X.X........
...X.....X..XX....X....X..X.....X.....X....X....XXX.
XX..X...........X........XXX.XX....XX.X.......XXX...
..X.X......XX...X.XXXXX......X........XXXXXXX..XX..X
....XXX..X....X.X.XX......X....XX....XXX..X....XXX..
.X...XX..XX...X...X..X....X.X.....X....X....XXX...X.
...X.X...X....XX..X....XX...X.X...X.X....XX.....X...
X..X...X...X..XX..XXX..XXX..X...X...X.......XX..XX..</walls>
			</board>