<?xml version='1.0' encoding='UTF-8'?>
<board>
				<level>69</level>
				<width>26</width>
				<height>26</height>
				<walls>X...............XXX...X...
..XXXX..X........XX.X...X.
....XX..X...XX.X....XX....
..X.....XXX.XX....X.....XX
...XXXX.........XX..X.X.XX
.X.........X.......X..X...
..XXXX.......X....XX......
X......X..X....XX.X..XXX..
XX....XX....X........X....
XX.XX....X..X...XX.X......
X...X.......XX..XX.XXXX...
X.X.....XXX....X........X.
..X..X......X.........X.X.
.XX....XXX......X..X......
....X...X..X....X....X.X.X
X.....X...XXXXX...X....X..
..XX..XX......XXX...XXX...
.XXXXXXX.X....X....XXX..XX
..XX...X...X....X......X..
X.XX.X...XXX...XX.X.XXX...
.....XXX.....X..X.X.....X.
.X.XX...........X....X..X.
.X.XX.X.....X......X.XXX..
.X....X...X......X...XX..X
.....XX...X.........XXX...
..XX....XXX.......X.......</walls>
			</board>