<?xml version='1.0' encoding='UTF-8'?>
<board>
				<level>144</level>
				<width>51</width>
				<height>51</height>
				<walls>..X......X...X...X....XXXX..X.....X.....XX.........
....XX.....X...X.X.......X....X.....X......XX...XX.
...XX.....XX..XX.X...X.X...XX......XX..X......X....
.XX...X....X.......X.X....X...XX....XX.X...X....X..
.XX....XXX.X..X...XX....XXX..XX..XX......X.X.......
.X...X...X..X.X.......X..XXX.XX....X..X......X.....
...X.X....X.......X.XXX......XX.XX.X......X.......X
X..X.X..X....X.X....X......XXXX.XX...X....X.X.XXX..
..X..X..XX.....X.X....XX.X....X.....XX....X.X....X.
..X.....X..XX........XXX..XXX.....XXXXX...X......X.
......XXX.XX....X....X..X...X..X........X..........
.XXXXX....X..XXX..X..X......XX...X........XX.....XX
...XXX......XXXX...X...XXXX........X......X..XXX...
XX.X....X..X.....X..XXXXX...X...XXX..X......XXXXXX.
...X.....XXX.XXX....XXXX.....XX.....X..X.XXX.......
.......X..XX.X....XX.....X.X....XX.....X..XX...XX..
XXXXX...X..X....X.XX....XX..X......X......XXXX..XXX
XXX...X.XX....X.X.XXX...XXX...XX.XX...X.....XXX....
..X......X..X.....X.....X.....X..X..X...XXX.XXXXX..
....XX.X.XX......XX.XX..X.....X....X...XXXX.......X
.......X.....X......X..X......XXXXX..X...XX.......X
...XXX..XX.X.......XX..X.X.......X..XX......XXX...X
.X..XX.....X..XXXX.XX....X..XX.X.X...X..X..XXXX....
....XX...XX...XXXX....XX..X..X....XX.XX....X.....X.
X...XX....X.X..XXX..XX....XX....X.X..X..XX...XXX...
..X...XXX......XXX...X..XXXX........XX.XXX..XXXXX..
...XX.X..XXX.....X.X..X....X.XXX.....X..XX........X
.X..X....XXXXXXX......XXX............XX.X..X......X
..X......XXX....XXX.......X.X.XX....X.....XX.XXX...
X....XX.......X.XX...X...XX...XX.XX....X.....XX..X.
XX....X...X.X.X..X.X.....XXX........XX......X...X..
X..XX.XX..X....X......X..XXX..X...X.X...X.....X...X
X.....X..X...X......X....XXXX...X.....X...XX.....XX
..XX....XX.X....XX....XX.XXXX....X......XX..XX.X..X
...X.X..XX....X..X....XX.X.....X........XX...X..X..
XX.....XX...X..X.XX...XX.....X.X..X.....X..X.XX.XX.
....XX.X..XXXX.X..X...X...X..X..X...XX....X..XX....
.........X.....XX.......X...X...X.XXXXXX....XX....X
XXXXXXX....XX.....XX...XX...X.........X..X.....XX.X
XXXX..XXX..X....X....X.........X.X....X....XX...X.X
XXXX....X..X.X..XX.....X...XXX.X....XX..XX....X...X
XXX..XX....X..XX....XX...X..XX....X..X.......X....X
XXX.X......XX..X..X..X....X..XX....X......XX.X....X
..X...X...XXXX..X..X.X..X....X..XX.X..XXXXXX.....XX
......X.X.XX....XX.X.......X...XXX..X...XXXXXX.....
.XXX....X.XX.X...X.XXXXX.XX....X..X...X.X...XX..XX.
..XX.X.....X...X...XXXX..X..X..X.....XX...X.X...X..
X........X....XXX..XXXX....XX..X...X...X..X...X.X.X
..X.XX......X.....XX..XXX.....XX.XXX......XX..X.X..
....X..XX.XXXX....XX......XX..X..XXX..XX......X.XX.
......XXX......X..XX.........XX..........X....X....</walls>
			</board>