<?xml version='1.0' encoding='UTF-8'?>
<board>
				<level>131</level>
				<width>48</width>
				<height>46</height>
				<walls>.....X...XXXXX......X.....XX..X..........XXXX...
...X...X...XXX...XX.....X.....X....X...X......X.
....X......X..X..X...XX...X...X..X...X.....X..X.
..X...X.......X.XX....X.....X.X..XX.....X....XX.
...XX.......X...XX..X....XX.X..XX...X...X.X.....
...XX..X....XX..XX...X.........XX..XXXX.....XXXX
X...XXXX.X..XX.....X...X...X....XX.......X....XX
X.X............X.........X......XXXX...XXX.XX...
..XXX...X....X........X.....XXX..X...X..X..X..X.
.XXX..X...XX....XX....X..XX......X.XXXX...XX....
.....XXXX....XX.....XXXX.......X.......XXX...XXX
...........X.X....X....X..X.......X....XX..X..XX
.....XXX...X...X.......XXXX..XX......XX...XX..XX
X....XX..XXXX....X......XXXX.XXXXX.X....XXX...XX
..XXXXX.......XXX.....X........X...X..XX....X.XX
.XXX...XX.....XX..XXX.......X....XX...X....XX.XX
.X...X....X......XX....XXXXXX.X...X.X...X...X..X
.X......X....X....X.XX..XXX.....X...XX....X.XX..
....X......X...XX...XXX.....XX.....X...X..X.....
XX..X....X....X.....XXX..XXXXX.XX....X....X..XXX
...XX.......X.X.....XXX........XX.X....XX....X..
..X...XXX...X....XXX....XX........XXX......X.X..
X...X.XXX...XX...XXX...........X....X.X..X.X....
..........X..X.XX..X......X.X....X....X..X.XX...
.XXX.XX......X..X....XX.....X.X....XX....X....X.
...X......XX..X...X..X...X....X.......XX....X.X.
XX.....XX..XX..X.......XXX...X............X.X...
XX......XX...X...X..X...XXXX.X.........X....XXXX
XX..XXX.X........X....X.XX.....XXXX....X.X...X..
XXX..XX...X........XXXX.....X..X....XX.....X....
XXXX.....X....XXX...X.......X.XX..XXXX..X.....X.
...XXX.....X..XX..X.........X.XXX....X....XX..X.
.X.....XX....XXX.....XXXXXX...XXX..X.X...X...X..
....X...XXX........X..XXXXXX..XXXX...X.......X.X
X.....X.....X....XXX..XX.........X..X........X..
X..X...X......XX..X...XX.....XXX.XX.X.X.........
XX.....X.XXXXXXXX...X.....X..X...X..X...XXX...XX
....X..........X...X....X...XX.....X...XXXX....X
.XX...X..........X.X.XXXX........XX..X....X....X
.....XXXX...XXX......X..X........XX...X.....XX..
..XX.XXX..X...XXX.......X.....X.....X........X..
..XX.XXX.XXX..XXXXX...X.........X.X.X..X..XX....
XXXX...X.....XXX....X..XXX...X....X.X....XX.....
.......X...XX..X.....X..XXXX.X.X....X.XX..X.....
....X....X.XX.....XX..X....X....XX....XXX....XX.
..X...XXXX....XXX.....X..X....X....XXXXXX..X....</walls>
			</board>