<?xml version='1.0' encoding='UTF-8'?>
<board>
				<level>79</level>
				<width>30</width>
				<height>29</height>
				<walls>..X...X......XXXXX.......XX...
....X...X......X...XX.......X.
.......XX...X..X.XXX..X...XXX.
XXXX.XXX....X....X...XX.X.....
..X..X...X....X.....X...X....X
....X......XX...X.X.X....X...X
.XXXX.X...XX..XXX......X.....X
..XX....XX...XX...XX.X.XX....X
X....X...X....X.X..X......X..X
..X..XXX....X...XX....XXX.XXXX
..........X..X....X.......XX..
.XX.....X.XX....X.X......XXX..
.XX...X...X...X.X..XXX........
.XXXX...XXX......X..........X.
...XX....X.....X.XXXXXX.......
XX.XX..X...X.....XXX...XX..X..
...X......XX.XX......X.XXX....
.....XX.XX...XX.....X..X......
XXX..XX.XX..X...XXX.X.........
..X...X..XX...X.X.......X.....
....X....X...XX.X..X.XX.XXX...
.XX........X..X..X...XX.......
....XXXXX.....XX....XXXX...XXX
XX......X...XXXXX........X....
X..X......X.......XX....X..XX.
X....X.XX...X...XXXX..X..X....
..X..X.X....X.X.XX...XXX.....X
.......X.X..X......X.XX....X..
.........X.....XXXXX....XX....</walls>
			</board>