<?xml version='1.0' encoding='UTF-8'?>
<board>
				<level>90</level>
				<width>33</width>
				<height>33</height>
				<walls>X..X.....X...XX...X..........X...
...X...X...X..X.X.........XX...X.
.X.XX......XX........XXX..X......
.X....X.XX.X...XX....X...X..XXXXX
...XXXX......X.....X.....X...X..X
XX........X......X...XX..XXX.X..X
....XXXXX.XXX.X..XX..X....X..X..X
.XX...XXX.XXX...XXX..X....X.XX..X
......X.......XXXXX..X...XX.XX..X
..X......XX.........X..X.XX.....X
X......X.XX....XX...X.XX.X....X..
X....X.X.X.....X......XX...X.....
...X.....X.X.X...X.XX..XXX...X.XX
.X...XX......X...X.....XX......XX
....XX....X........X...X..X.XXX..
..X.XX.XX.XXX........X.X.XX..X...
.....X.XX.XX..X...XX...X...X...X.
...X...X..XX......XX....X..XX..X.
XXXXXX...XXX.......X..X.X.X..XXX.
XX.......XXX.......XX.X...X......
......X....X..........XX....X....
..X.X.X.....X.....XXXX...X.......
X...X...X.X...X...XXX..X...X.....
X..XXXX...X..X........XX...XXX...
XXXXXXXXX..X...X.X....XX.....X...
...........X.XXX....X.....X......
......XX...X.X....X...XXX...X....
X.....XXXX...X...........X.....X.
..XX..XXX...XXXXXX.....X.....X...
.XXX..XXX...XXX.............X....
....XXXXX..XXXX.......XX......XX.
..X....XX....X......X..X.X.X...X.
..X..X....XX...XX...XX...X...X...</walls>
			</board>