<?xml version='1.0' encoding='UTF-8'?>
<board>
				<level>158</level>
				<width>57</width>
				<height>55</height>
				<walls>XXX....XXXX...X.....X....XXXXXXX...XXX..XX....X...XXX...X
XXX..X......X.....X.X........XXX.X...X.....X....X.....X..
X..X..X....X...X..X.....XX.......XXX.X...X...X...X....XX.
...XX.X......X...XXX....X..XX......X...X.......X.X.XX.XX.
.X..X.X...X......X..XX....XXXXXXXX.......XX........XX....
..X.....X....XX........X..XX.......XXXXXX...XXX.XXX...X..
X...XX.XXXX.....X....X.....X.........XX...X.....X...X....
X......XX...X............X.X......X.....XXX..XXXX......X.
X..X.............X...XX......X....X...XXX......X..XX...X.
.........X.........X....X...XX...X..XXX....XXX.X..XX.....
.XX...XX...X....X.X...X...XX..XX.X.......X.XX..X.........
....X..X.....XX...X.X.....X........XXXXX....X.XX...X.....
X......X......XX.....X......X...X..XXX....X.X.XX.....XXXX
..X..X........XX.X.X...X.X..X.X.X....X........X..XX...XXX
.XX.....X........X...X......X.X...XX...XXX.XX.......X....
.XX...X...XXXXXXX.......X.....X..X.........X.........XX..
.XX...XXX...X..X..X.X...X..X...XXX....X......X.XXXXX....X
....XXX.....X....X..X..XX...XX.XX.....X.....XX..XX..XX..X
XX............XXXX.XXX....X..X....X......X......X...X....
XX.XXXXX.....XXXXX....XXXXXX...X..XXXX.XXX.X.XX...X...XX.
...XX......X....X.........XX.......X...XX....X.......X...
..XXX...........X.......X.X.....X..X.XX...X....X...X...XX
X.......XXX.X...XXXXXXX.X...X.X...XX.X..XX.....X...X.....
XX..X...XXX...X..X..........X......X...XX..X...XXX.X.....
....X..XXXXXXXXX.X.XX..X.........X....XXX.....XX...XXXXXX
..X.XX....XX.....X..X..X...X.XXXXXX...XX....X..X....XX...
X.X.....X.XX......X.X....X...XXXXXX..XX..XX..X.XXXX....X.
.....XX......XXXX.....XX....XXXXXXXX..X......X.XX...X..X.
.X.X.....X......XX........X..XXXXXXXX......X...XX.X....X.
...X..XX...XX.X.X.......X....XXXXXXXX..XXX.....X..X..X...
......XX..XXX.....XXX........XXX........XX.....X.X......X
....X...X..X...X.............X.......XX.XX.....X....X.X..
..X...X..X.X.....X...X.....X....XX...XX...X.......X.X....
XXX...XX.....XX....X...XX.......XX.XX...X.X...X..........
........X.XX......X...XX..X.XX......X.X...X.....XX...XXXX
.XXX.X....XX..XXX...X....XX....XX.X...XXXXX........X...XX
.XX..X.X...X...X....X...XX..X.....X....X.......X.......XX
..X......X...X.X.X..X.X..X...XX.X...XX.....X.X...XX.....X
X.....XX.X..XX........XX...X.XX....XX........X..X....XX.X
X..XX..X.X......X......XX........X.XX.........X...XX..X.X
XX.....X...X.......XXX....X...XX......XXX.....XXX...X...X
...X...X..XX.X...X.XX..XXX..X.....X...X...XXX.....X......
.XXX...X...X..XX.X.XX..X...X..XXX....XX.....X.XXXXXX..XX.
..XXXX...X.XX....X.XX....X...XXXXX.X......X....X.....XX..
X.....XXXX.....XXX..X...XX......XX...........X...XX.....X
XXX......X...X...XX.X....X..XX......X....X....XX....X....
...........X.....XX....X....X..X......XX......X..X....XX.
...X....X.....X...XXXX.XXXX...XX...X.XXX........XXXX...X.
X........XX.X...X...XX....XX.....X...XXX.......XXXX..X.X.
..X....X..X.........XXX...X..XX.......XX..XXXX.XXX..XX...
.XXXXX.XX....X...XX...X.XXX...X.....X.X....X...XXX.X....X
.....X...XXX.....X..X...XX....XX..X...X.XX.......X....X..
.......X..XX..XXXX.X...XXX........X.......X...XX...XX.X..
....X...X..X...XXX.X.X.X....XXXXX....X......X..X....X....
..X...X....X...XXX...X...XX........X.....XX....X..X......</walls>
			</board>