<?xml version='1.0' encoding='UTF-8'?>
<board>
				<level>121</level>
				<width>44</width>
				<height>43</height>
				<walls>...XX.....X......X...X....X..XXXXX..XX......
.X....XXX.....XX.X.X...XX.X..XXXXX..........
...X..X....X..XX...XX..XX....XXXXX.........X
XX.X..X......XXXXXXX.........X...XXXXXXXX..X
.....XXXXXX......X...X.........X...X......XX
..X....X....X......XX.........X..X...XX..XXX
X.X....X......X...X...X.XXXX..X......XX.....
..X....X...X....X.....X...XX.XX.........XX..
.XX......X.X...XX.XX....X......XX...X.X....X
.XX...XXX....X..X..X.X....X.......X.X.....XX
.X..XXXXX.X.....XX.X...X..X...XXXX.....XX.XX
...X........XXXX...XX..X....XXXX...X......XX
..XX.....X.X...X...XX....X...........XXX....
X.....X..X...X........X....XX...X.....X..XX.
..X.X...X....XX.....X.........X...X.X...X...
.X..X...X....XXXX....X.....XX..XX...XXX....X
.X..........XXXX...X...XXX.....XXX.......X.X
....XX.........X...XX....XXXXX.....XXX...X..
XX.........X.X.XXXX...XX....X..........X..X.
...X.....X.X....XXX.......X...X...X.......X.
..X....X......X...X....XX..X....X.....X.....
X...X.....XXXX....X.X....X.....X...XX.....XX
X..X..X.XXXXX..X....X.X.....XX.X....X.......
X....X..X...X.XX........XXX.........X...XX..
..X....XX.X......XXX.X......X...X...X...XX..
.X..X........X.X.XXX.X...X..X...X.X......X..
...XX..X.XX....X.....XXX..XXXXX......X.X...X
.....X.X....X...XXXXXXXXX....X...XXX.X......
...X.....X....X............X...X..XX.XX.....
XX.XX......X..X...................XX....XXXX
XX..X.....XX.XX.X.........X.......XX.....XXX
XXX.XXX.......X........X..X.......XX...X.X..
........XXX.X....XX...........XXX...XX...X..
...X....XX..X.....X...X....XX.X.....X.......
...X...XXX.XX...X..XX....X......XXX...XXXXX.
.....X.....XX...XX..X..X.XXX...XX...XXXXXX..
..X..XX.........XXX.X.....X..X......X....X.X
XX...X.......X...XX...X.X...XX.X......XX...X
...X...X.XXX...X...XXX..X..XXX...X..........
..X..XX..XXX..XXXX...X......XX....XX...XXXX.
X.X..XX....X..XX......XXXXX..X..X.XX.X..XX..
X.X...XXXX.X......X.X.....XX.X.....X..X.X..X
X...X......X....X...X..XX....X...X....X...XX</walls>
			</board>