<?xml version='1.0' encoding='UTF-8'?>
<board>
				<level>148</level>
				<width>53</width>
				<height>52</height>
				<walls>X.......XXXXX......XXX......XX.....XX...XX....XX.....
X...........X.X....XX..XX......XXX..X...X..X.....X...
X...XX......X.X...XXX.XX.....X....X.X..X..XX.X.X.....
XXX....X..XXX.XX......XX.X.....XX.X.X....X.....X..X..
.X.....X..XX..X..X.......XXXX..XX.....X....XX.XXX..XX
.X.X..XX..XX.XX.XXXXXX..XXXXX......X....X..XX...XX...
...X...X.....XX....XXX........X......X....XX....XXXX.
X....X...X...XXX...X...XXXX.......X..X.XX....X.....X.
....XX..XX...XX....X.X.........XX......XX........X...
.XXXX....XX..XX.X....X.....X.......XX..XX...X.X....XX
..X...XX.....X....X..XX......X...X.....XXX....X.X....
X.X...XX...X...X.....XX...X....X...........X......X..
X........X.XX........XXX....XXXX..........X....XXXX.X
XX.....XXX....X.XXXX..XX.X....XX.......XX...X.......X
.......XXX..X...X.....XX...XX.XXXXX........XX...XXXXX
.X...X..XXX....X..X...XX......XXXXX.X...XX...XX......
...X....X....X.X.XX...XX..XXXXX.......X...XX...X.....
X.....X....X.X...XXXX..XXXX........XX.......XX....X..
....X......X.XX..XXX...XX...XX.X...XX....X....X.X.XXX
.....XXXX....XX..XX..XX.....X..X.X.....X...X....X....
XXXX...X..X..X....X.XXX.XX..X.XX.X..XX.....X.XXXXX...
....XX...XX....XX...X....X..X....X.....XX..X.......XX
.XX.........X.X........X.X.......X...X....X..X...XXXX
.....XXXX.....X.XX...X...XXX.XXX...XXX..X.X....X.....
XX.X....X.XX....X..X..X..XXX..XXX..XXX......XXXXX....
XX...XX.....XXXX..XXX.......X.XX...XXX...X.....XX.X..
XXX..X...X....X..X.....XX...X....X.XXXXX...XXX.XX.XXX
XX..X..X...X....XX...X.X....XXX..X..X.....X....X..XXX
XX....XX...X...XXXXX.X...X..X.......X.X.X.X.XX...XXXX
XX.....X...X............XX..X.....X...X.X.X..........
...XXX.......XX...X...X.......XXX....X..X...X...XX...
.X..............X...X....X....X....X.X..........X....
....X.......X................XX........X.....X....X..
X.........X...XX...X......XX........X..XXX...X.X.....
.......X.....XXX.X...X................XXXX.........X.
.XXXXX...X.X.X...X.XXXXXXXX...XX.....X........X.XX...
.XX........X...X.....XXXXXX.X.XX.X...X..........XX.XX
..X.X.....XX..X...XX......X....X.X..XX..XX...X.......
X...XXX.XXXX..X.X.....XXX....X.X..X..X.....X.XXXX.XX.
XX..XXX..XXXX.....X.............X..X...XXXXX.X....X..
XX..XX...X........XXXXXX......X....XXXXXXXX..X......X
X......XXX...X........X..X.......XX.........X..XXX...
..XXX....XX......X....X....................XX......X.
...XX.XX..X.X.XXXX.X......X.....XX...XXX...X..XX.....
XX....XXX.X.X..XXX.X.X...XX..X..XX...X.....X.X.......
X.......X...XX.XXX.X...X..XX.X.....X.......X....X....
..XXXXX........X...XX..XX......X...X.XX......XX...X..
....XXX..X.......XXXXXXX......X..X.X....X....XXX....X
XXX.XX.....XXXX..XXXXXXX.X......X..XXX..XXX......XX.X
..X.X..XX..X...........X........X.XX...XX...XXXX....X
....X.XX...X.XXXXX.....XX.X.....X.X....X..XX...X.X..X
......XX...X.......XX..XX...XX..X...X..X.....X...X..X</walls>
			</board>