<?xml version='1.0' encoding='UTF-8'?>
<board>
				<level>150</level>
				<width>53</width>
				<height>53</height>
				<walls>......X..X..X......X..X..XX..X...X....X.....XXXXX....
....X....X..X......X..X..XX....X.X.XX...XX......X.XX.
X.....XX....XXX....X..X..XX........XXX.....X.XX...XX.
............XXX.XX....X..XX.....X.X..X..X..X...X.....
.X...X......X.......X....XX...X...X..XX...X..X......X
...X...XXXX....X.XX...XX..X.X....X...XXX..X..XX.X...X
X.....XX.....X.X..........X....XXX.X...X.XX...X....XX
..X.X..X.......XXX...X.....XXX..X....X.X....X....X.XX
.XX..X.XXX..X..XXX.X...XXX.XXXX...X....X..XXXX.....XX
.....X.XXX....XX...X...X...X...X....X...X.........XXX
..XXXX.....XX.X..X.....X.....X.XXX....X...XXX.XXX....
XX..XXX...XXX.X....XX.....X..X...XX......XXXX..XXX...
....XX..X.XXX.....XXX...X.X......XX.........XX.X.....
..X....X..X....XX.XXXXX.....X....XXX....X......X.....
X.XXXXXX.......XX.XXXX...XXX..XX.XXX.X....XX.........
X.......XXXX...XX..XXX.......X...X.....X..X.....X....
XXX..........X..XX.....X..X....X....X.......XXX.X....
.....X...X...XX..XX....X...XX.....X....X...XXXX......
.X.X.X.X....XX...XX..XXX.X....X...XX.....XXX.....XX..
.X.....X..X.XX.XXXXX...X..XXX.XXX.....XX..XX...X..X.X
.X..X.....X.X..X..XX...XX..XX.....XXX.....XXXX.XX....
.X..X...X...X...........XX...XX.......XXX...X......X.
.X....X....X...XX...X.X....X.....X..X.....X...X......
...X.........X....X...X..X.....X..X..XXXX..XXXXXXXX..
..XX.X....X.....XXXXXXXX..........XX...X...X..XX.....
..XX.XXX......XX.....X..........X........X....XX.....
..XX..X..XXX...X...X....X...X.........XX......X.....X
XXXXX...X....X..X.....X.X.X....X.......X.XX...X...X..
.....X......XXX...X.X...X....X......XX.....XX........
.....X.XXX...XXXXXX.....XX...X..XXX...X.X....X...X...
XX...X.XX..X.......X....X....XXXX.......X.X....X...X.
...X......XXXX...X...X..X.........XX........X......X.
.XX...X..X.....X.....XXXXXXXXX..XXX...XXXX....X....X.
.XX......X....X...X......XXXXX..XX..X....XXX....X..X.
....XX...XX.....X...X........X.....XXXX....X.XX.X..X.
..X....X.XX..X...X......X......XX...X...X....XX.X....
..X..X.X...X.....X...X..X...X.....X.X.....XXXX......X
XXX..X.....XXXX..XXX.X....X....X..X............X.....
XXXX....XXXX.....X...X.XXXX..X.X....XX..XXXXX.....XX.
.....XX..XXX...X.....X..XXX..X.X.XX....X...X..XXX.X..
..X......XXXXX..XXX.....XXX..X.X...X.....X...X......X
X.XXX....XXXXXX....XX....XXX.....X....X........XXX...
X.XXX..X.........X.X...X...X.XX.....X.....XXX....XXX.
..XXX........X...X...X.....X.X..X......X....X.....X..
.XXXX.XX..X....X....XX..XXXX.X.XX....X.X.X...XX.X...X
......XX..X.X...X.....XXXXXX...XX..X.X.....X....XXX..
X.....X...X.X.X....XX..X....X...XXXX....XX....XX.....
..XXX.X.X.....X..X.XXX....X.X.X...X...XX....X.....XX.
.XXXX......X........XXX.X.X.....X...X....XX...X.X....
...XX..X.X........X...X......XX...XX...XX.....X..X...
....X..X....XXXXX.......XX.X..X...XX.X.XX........X.X.
..X.X...X.......X..X.XX.XX....X....X.X....XXXX.....X.
..X...X.........XX...XX.......X..X...X..X............</walls>
			</board>