<?xml version='1.0' encoding='UTF-8'?>
<board>
				<level>58</level>
				<width>23</width>
				<height>22</height>
				<walls>..X..X...XXXX..X...X...
..X....X....X....X.X.X.
....X.....X...X......X.
.XX...X......XX..XX.XX.
.X....XXXX....XX....XX.
.X.X..XXX.....XX..XX...
.X.X......XX...X......X
.....XXX.....X.X....X..
X...XX....X..X..X...XX.
XXX.X...X...XXX...X....
X...X.X.XX..XXXX..XXXXX
X.......XX..XXXXX...X..
....XX...X..XX....X.X..
.XX......X..XX.X....X..
............X..XXX.....
..XXXXXXX.....XXXXXX...
....XXXXXXXX..X...X....
........XX....X.X...XXX
...........X....XX.....
.....XXX.X...X...X.XXX.
.......X.......X...XXX.
XXXXXX......XX.........</walls>
			</board>