<?xml version='1.0' encoding='UTF-8'?>
<board>
				<level>64</level>
				<width>25</width>
				<height>24</height>
				<walls>...XX......X......XX...XX
.X....XXXX.X..XXX....X.XX
.....XXX...XX....XX..X.XX
..X....X.X..XX.....XXX.XX
X...X....X..XX.XX...X....
..XXX.......XX....X...XX.
.XX..X....X...XXXXXXX....
.XX....X..XXX...X.......X
....XX...XXX....X....XX..
X..X.....XXX.....X...XXX.
X..X..X..XXXXXXX...X.....
...XX....X..X...X........
.X.....X....X.X.X.XX.....
.X...X.XX...X.....X..XX..
...X.X.........X....XXXXX
.........X...X...X.......
....X....X...X.XXX...X...
XXX...X..X.....X...X.....
X.....XXX.....XX......X..
X..X...XX.XXX.X...X.X.X..
XX...X....XX..X.X...X....
....XX..XX...XX....XXX...
.XX.XXXXX....X...XXX.....
.XX.......X..X.......XX..</walls>
			</board>