<?xml version='1.0' encoding='UTF-8'?>
<board>
				<level>115</level>
				<width>42</width>
				<height>41</height>
				<walls>...........XXX....XXX...............X..XXX
.X......XX.X......X...X....X......X....XXX
.X.X.....X....X...X...X.XX...X.........XXX
...X.X.X.XXXX.X.X.....X.X.......XX.....XXX
X......X.XX...X..X....X....XX.X...XXXX..XX
X..XX....XX....X..XX.....X.XX...X.......XX
XX.......X..XX.XX....X..........XX....XX..
XX..X....X.....XX..X...XX.....X.XX.XX.....
XXX...X..X......XX..X..XXXXX..X....X...XX.
........X.......X...X.XXXXX..X...XX..X....
...X......XXXXXXX.X......X..X..X.X..XX..XX
X..XXX...XXXXX.......X...X.X..XXX..X......
X.XXX..XX.......XX.X.....X...XX...XX......
..X...X.....X.X.XX...........X..X...XX....
.XX......X....X..X..X..........X..X.XX.XX.
.....X...X.X...X.X....X.....X....XX.X.....
..X....X.....X.....X....X.X.....XX..X.X.XX
X...X...X.......XXXX.X....XX....XX....X...
......X..XX............XXXXX.X..X..X......
.X.....X..X.........X...XXXX..XXX......XXX
...XXX..X...X...XX......X..XX.....XX.....X
...XX...XXXXX.X....X.......XXX.....X.XXX.X
......X..............XXX...X...XXX.....X.X
..X..........X.XXXXX.....X........X......X
X...XX...X...X.....X..X..XX.....X.....X...
.......XX......XXX......XXXXX...X..X....X.
.X...XXX..X.........X..XXXX..XX.X..X.X..X.
...X..XX.XX.....XX..X.....X.....XXX..X..X.
XX.XX.......X......XX...X...X....XX.XX..X.
XX....X...X.....X.....X........X....X...X.
XX..X..XX....XX...X.......XX.X.XXX..X.X...
....XX...X.XXXX......X....XX...X......XX..
.XX.XX...X..XXX..X.X...X..X....X..........
....X.......XXXX...X....XX..XX......XXXXX.
X...X.X...XX......XX..X.XX.X....XXX...X...
..X.....X......XX........X......X.......XX
.XXX...XX...X..........X......X..........X
.....X..X.....X...............X.XX.....X..
X.......X..XX....XX.....XXXXX...X..X...XX.
X..XX..........X.XX.XXX..X...X..X.....XXX.
XX.............X....XXXX...X........X.....</walls>
			</board>