<?xml version='1.0' encoding='UTF-8'?>
<board>
				<level>125</level>
				<width>46</width>
				<height>44</height>
				<walls>...X...X..X.....X..........XX..X.........X...X
.X...X....X.XXX...XXXXXXXX.....X....X..X...X..
...XX...X................XXX...XX...X.....XXX.
XX....X..X.X...XXX.......XX..X..X.XX..X...XXX.
XXXX...X.X...X...........XX.....X....XX...X...
.....X...XX.......XXX....XX......XX.......X.XX
.....XX..X....X.......X..X....XX.XX.XX....X..X
X....X...X.X............X..X..XX.......X..XX.X
..X....X...X.X.XX....X....XX.X.....X.........X
.XXXX.....X....XX.XX.X.X.......XX.....X.XX...X
......X.....X.XX..XX......X.XX....X.X.X....X..
X.....X....XX.X..XX...X...X.....XXX.....X.....
..XX....X.....X.XXX.X.X..X....X....X........XX
.XXX...XX.X.....X...X.X....XXXXX...X...XX...XX
...XXX.XX......XX.......XXXXXX.......X....X...
.....X.....X.......X...XXXXXXX..X......X......
..XX.....X...XX....X.X..X....XX.....X......XXX
...XX....X....X...XX....X..X.....XX...X.......
.X..X..X....X...X.X...X..X...XXX..X..XX.......
....XX....X....XX.X.X....X........XX..X.XX....
X............X......XXX.....X...X..XX...X..XX.
....X....X.......X......X.XXX.X....XXX....XX..
.X....X.....X....X.....XX..........X...X.....X
...XX.X...X........X......XXXX.....X..XXXX....
XXX...X.........XX......X...XX..XX..X.........
....XXXX......X.....X........X...XX..X....XXXX
....XXX..XX.......X...XX...X...X..XX...XX..XXX
X.....X...X..X.........X...XX..XX.......XX.X..
..........XX..XXXX...X...X.....X...XXXX..X....
.X...X......X......XXXX......X...X...XXX.XX...
..........X....X..XX....X....X..XXXX.X.....XX.
X.....XX.....XX...X..X..X....X.....X...XX.....
...XX....X....X.X...X...XXX....X.......XX...XX
.X....X...XXX.......X...XXX.......X....X..XXXX
.....XX.X...XXXX....X..XXX..XXX.X.XXXXXX......
XXX.....X.......XXXXX....X....X...............
....X......XX.......X.XX...XX..X.X............
..XX.....X..........X.....XXXX.X.....X....X...
X..X.........X....XX....XXX..X....X....X......
XX.X......X....X...X.....XX..X..X...X.XX.X....
.....X....X.XX...X.....X.....XXXX.XX..XX...X..
.XX.XX.X..X..X....X........X......X..XXXX....X
..X.....XX...X.XX.....X.XX..X...XXX.X........X
X.....X....XXX.....XX...XXX...X.....X........X</walls>
			</board>