<?xml version='1.0' encoding='UTF-8'?>
<board>
				<level>120</level>
				<width>43</width>
				<height>43</height>
				<walls>X..XXXXX....X...XX..........XXXX.....X...XX
X.....XX.X....X....XX.......X......X...X.XX
X...X.X..X.X.XX..XXXX...XX..X.X.......XX...
X...X...XX...XXX..XXXX........X.....X....X.
X....XX.......X........X.XX..X....XXXXXX...
X....XX.XXXXX...X...X..X..XX...X..........X
..XX.......X..XX..X....XX.XX...X.X......X..
...X.X.XXX.X.....XXX......X....X...X.......
XX...X..XX...X..........XXX.X..X..XX.X...XX
......X.....XX......X...XXX.X..XX....XXX...
........X...XXXXXX..XXX.XXX.X.....X........
..XX......XXXXXXX..X..X.....X..X....XX.....
.....X.XXXXXX.....XX..XX...XXX...X.....X...
.XXX.X........XX...X.....X.XXXXX....X..XXX.
.....X.......X...X...X.....XXXX...X.....XX.
...XX..XXX.....X....XX.XX..X....X.X..XX..X.
.X..X..XXX.XX.X...XX...XXX...X....X...XX...
.XX.X..X...XX...X.....X.......XX....X.X...X
..X.X........X..XXX.X.X.....X.XXX..XX...X..
X.....XXX.X..X..XXX...XX....X..XX....X..XX.
XX........X.XXX..X..........XX....X....X...
X....XXX....X....X...XXXX...XX..X...X....XX
..XX.X...X..X..X..XX......X..X..X...X.....X
...X...XXX...X....XXX..X.....XX.....X...X..
......XX...X....XX.....X.X....X.XX..X.X.XX.
....XXX.......X..X..XX.....XX...X...X...X..
..XXXXX.X...X.XX.XX.....X..XXX..X...X..X..X
....X.....X...XX...X....X...XXXX..XXX....XX
.XX...XX....XXX..X...X..X.X....X...X..XXX..
.X............X......X..X....X...X...X.....
...XXX..........XXX..XXX...XX.....X......X.
....XX...X...XX.....XXXX.XXX..XXX.X...X..X.
..X..XX....X......XX...X..X..XXXX.XX..X.XX.
X.XX.X..X....X.......X.XX...X...X.....X....
.....X.XX.....XX...XXX...X..X.X.....X..X...
.X......X...X....X..XXX....XX.X..X.....X.X.
......X.X...............X...X..X...X.......
..X.......XX....XXX....X..X....X.....XX...X
..X.XX.....X.XX.X...XX...XX.......XX...XX..
..X.XXXX.X.X......X.......X..XX...XX....XX.
......XX.X...X......X..XX..X.XXXX..X..X..X.
.X.....X..XX....XX..X...XX....X....X...X.X.
.....X....XX..X.......X.....X...XXXX...X...</walls>
			</board>