<?xml version='1.0' encoding='UTF-8'?>
<board>
				<level>215</level>
				<width>76</width>
				<height>74</height>
				<walls>....X..........XXX..XXXX..XX...XXXXXXXX....XXX.....XXXX...........XXXX......
.XX.X.XXX......XXX.....X...X.X...XXXXXX............XXX..XX..X.......XX.XX...
..X...X...XX..XXX..X.....X...X........X...X.XXX...X....X....X..X.......XX.XX
X..XX....XXX..XX..X..XX.XX..XX....X.....X.X...XX..X.........XX.X...XX.....XX
XX.....X...X...X....XXX...........X.XX......X....XX.....X...XX...X....XX...X
X....X.......X.XXX......XXXXX...X......X.XX...X...X...X...X........X.....X..
..XX..X...XX...XX..X.....X....XX.....X...XX.....X...X.......X...XX.X......X.
....X...X.........XX.X.X...X.....X.X......X......XX......XX.XXX..X.X....X...
XXX....XX...X.X......X....XX.XX....X...XX.X....X.X...............X...X.....X
...X.X...X....X...X.............X.........X..X...X.X.......XXXX........X...X
.X...X.X...X.XXX..XXX....XXXX.X...X...X................XXX..X...X...X.....XX
.X........XX.....XXXXXXXXXXX..X.....X...XX...XXXX...X.......X...X.X...X.X.XX
........X....X..XXX.......X..XX.........XX.X......X.......X.....X.....X.X.XX
X.XX..X....X.X....X.XX......X......XXX.....XXXXX.....XX...XX....XX....X...XX
..X...X.XX.....XX...X..X...XX.XX.....X.X.X.......X.X....XXXX....X..X...X..XX
....X.X.XXX...XXXXX...XX...XX.XX...X...X........XX...........X..X....X.X..XX
XX..X.X.XX..X..X........XX.......X........XX........X..X..........X......XXX
XX..X.X.XX.....X..XX.......X...XXXXXXX..XXXX..XX.......X..X.XXXX....X....XXX
....X...X......XX....X.X.....X...X..XXXXXXXXX......X...XX.X..X...X..XXX..XXX
.XX.....X........X.....X..X.XX.X....XXXXXXXXXX.....XXX....XX.......XXXX.....
.XX..XX.....XXXX.X..X...X...X.......XX.......X....XX..XX......X....XX...X...
..X...X........X.XX.....X.....X.....XX...XXX.XX.......X....XX...X...X......X
X...X......X.X...X...X....XXXXXXXXX..X...XXX.....X......X....XX...X......X.X
..XXXX...X...X.....X.....XXX..X......X...........X.X...X..XX.....XX..X.....X
.......X.......XX.....X....X....XX......X...XX.......XX..XX....XXXX.......XX
.XXX.....XXXX..XX.X.....X....X...X....X...X....XXXX...X.XXX.X..XXXX...XX..XX
.....XX...XX...XX...XX....XXXX.X.XX...X.......XX...XX.......X..XXXXX...X.XXX
...XX...X....X.X.......XX........X..X....X....XX.X.....X....X..X.....X......
.X.XX.XXX..X.....X......X.....X....XXX...X...XX..X.......XX....X..X..XX.X...
.X..X..X........XX....X.XX........X...XX..X..X..XX..XXX..XXX...XX.XXXX..X...
.XX..X.X.XX.....XXXX....X..X.XX.....X.X...X.XX...XX.X........X....XX...XX...
.XXX...X.XX...X..XXX.X....XX.....X......XX..X..X......XXX......X..XX....X...
..X.......XXX....X.............X.XXX...X...XX......X...XX.X....XXXXXXXX.....
X...XXX.X.....XX...XX......XXX...X...X.....XX...X....X......X......XXX......
..XXXXX..XX...........XXXX..XX...X.XXX.....X..XX..X...XX......XX...XX..XX...
..X......X...XXXXX..X...XXX......X.........X.X...X..X......XX....XXXX.....XX
....XXX....X..X...XX.....X............X....X.X.....XX..XX..XX.X..X...XXX....
.....XX..XXXX...X....X.X...XXXXXX.......X..X....X...XX..XXX......X.X...X.XX.
XXXX..XX.....X.....XXX....X...X...XX.......XXXX...X.X...X...XX.....XXX...XX.
XX....XX..X....X...X....X...X........X...X.X......X.X.X....X....X....X..X...
...XXXXXX...X.X....X.X....XX.....X...X.XX....X....X......X.X.......X..XX....
.....XX...XXX...X..X...X..XX.XXX...XX..XX.X.....XX...X.....X..XX.X.XX..X.X..
XXXX.XX.........XXX...X......X.....XX.........X..X.X.......X..X..X...X......
XXXX.....X...XX.....X...X......XX..........X...X...XX......X....XX......X...
XXX..XXX...X.XXX...XX.......X.....XX.....XXX.X......X.X......XXX....X...X..X
XXX..XX....X..XX.X..X.XX.X....X......XXX..XX.XX.....X.XXX...........X...X..X
XXX.....XX.XX.XX.XX......X.X........X.....XX.X..X..XX.....X...X...X.....X...
XXX...X....XX......X...X.....XX..XX.X..........X...XXX....X.X...X.X.XX....X.
XXX.....X.......X....X....X......XX.XXXXXXXXX....X.XX..X....XX..X......X..X.
XXX.........XXX...XXXX.XX....X...XX.X..XXX....X..X....X..X.....X...X...X..X.
X...X............XX........X...X....X...XX.XX....XXX..X.X..XX....X...X....X.
X.....XXXXXX...X.....XX.XXXXXX....XX..X..X..XXXX..X...X.X.XX..X......XX...X.
..XX..XXXXX..X.....X.XX..XX.....X.XX...X..X...XXX...X...X..X......X..X..X...
....XX....X.XX..X........XX...X........XX...X...XX.......X...X....XXXX......
.......X..X.XXXXX.X...X...XXX....X.....XX.....X........X.XX....X..XXX..X....
.....X...XX...XXX...X...X.XXXX...X...X..X..XX.....XX...X....X.......X....X..
........XX....X.........X..XXX.X.XX.....X...XXXX.....XX.....X...XX....X....X
..XXX.X....X....XX.........X.....X..X.....X..X....XXXXX.....XXX....X....X..X
..XXX....XXX...X.......X......X....XX....XXX....X......XXXXXXX..X..X...XX.XX
.......XXXXXXX...XX.........X..XX...X.XX........XXX..X.X........X....X..X...
........XX...X..X...X...XXXXXX.X..X...X...XX.....XX..X...XX.............XXX.
XXXXXXX....X.XX...XX..X.....X....XXX....X..X.XXX.X...XX.....XX...X....X.....
.....X..X..X..............X...X.XXXX.X..XX...X...X.X..X....XXX......X....X..
.XXX.X.....XXX...X.....XX.....X.X....X..XXX....X......XX......XXX.X....X.XXX
.......XX..XXX...X.X...XX..XX...X..XX..XX...X.....X....X.XX.X.....X.XX......
....X.....XXX....X.X.XX..........X.....X..X.....X....X.X.XX....XX.......XXX.
.XX.........X.X....X..X.XXXX.....XX......XX..XXXXX...X.......X.....XX...X...
..X...........X.X..XX.....X..X......X.....XXX...XX.XX..XX........X.XX.X.X.XX
X.X....XXX......X......X....XX.XXX..XXXXX.....X.XX..X...XXXXX.XX.X.X....X..X
X..XXX......XX....X.XX...X...X.....XXXXX......X..XX...X...XXX..X.X...X...X.X
...X...........X..X..X.....X.XX..........XXXX....XXX..X......X.X.......X....
.X...XX..XXX.....XXX...XX..X..X.X...XXX....XXX....XX..X..X...X....XXXX.XX.X.
.....XX..........XX....X...XX.......XXX.XX.XXX.XX.X...XXX....XXXX..X......X.
XXX..XX..........XX....X...XXXXX........XX.....XX...X.....X..XXXXX...XX.....</walls>
			</board>