<?xml version='1.0' encoding='UTF-8'?>
<board>
				<level>176</level>
				<width>63</width>
				<height>61</height>
				<walls>..XXXX.............XXXXXXX........X...X........XXXX...XX.......
.......XXX...XXX......X..X.X...XX...X...XXXX......X.X....XXXX..
.X....X....X...X.XX.X.X....X.X.....XX..X..........X.X..X......X
.X.XX...X....X....X.....XX...X...X..X.......X....XX.X..X..XX..X
...X....X.X.....X.XX...X.....X.X..X.....XXX...X.....X...X.XX..X
..XX....X...X.XXX....X....X..X.XX..X.XX..XXXX.X.......X....XXXX
.......X....X..XX..XX...X.XXXX...X...X...X..X............X.....
.XXXX..X....XX......X.X.....X....X.....X....XXXXXXXXXXXXXXX..X.
..X...XXX..XX.....X......XX...XXXX.......XX..XXXXX...XXX.....X.
X....XXXX............X....X....X.............XXX...X.XX..X...X.
...X......XX.....X.X....X.X....X.X....X...XX...X...X....XXXX...
.XXX..X.......X....XXXX...X......X......XX...X.....XXX....XXX..
.X....X.....X...X...XXX.....XXX..X...X.........XX..XX..XX...XXX
.X....XX....X..X....X...XX....X....X......X.X..XXXXXX...X......
...........XX....XXXX...X.......XXXXX.......X.XXX...XXX.X....X.
XXX.....X..X..XXX.......X....X...X......XX......X.X..XX....XX..
XX..XXXXX.X..XXXX....X..XXXX...X...X.X.......X..X..X.....XX...X
XX.X..XXX...XX..XX...X....XXX..XX..X.X.X.......XXX....X..XX..XX
XX.........X....X....X.............X.....XXXXXXX....X....XXX...
X...X...XX...XX...X......X...XXXX....XX......X...XXX.....XXXXX.
X.....X.....X..X......X....X......X..X..XXX....XX....X...X.....
X..X.XXXXX..X...XX........XXX....XX....XX...X.......XXXX.X..XXX
X....X.....XX.X........X......XX..X...X...XX.....XX...XX..X....
..XXXX....XXX.X..XX......X....XXX...X....X...X...XX.......X..X.
.XXXXXX.....X.XXX...X..............X...X...X...X.......XX..X...
......X.XX..X..XX..XXXX...X......X...X........XXXX...X.....X...
..XXX.X.XX.....XXX...X..X.XXX.X......XX.....X......X.....X.....
....X...X..X......X..X........X.X.XX.XX.XX...X.......XX.....X..
.X.....XX....XXXX.X.X....XX...X...XX..X....X....X.X.....XX.....
...X...X....XXX...X.X.X.....X.......X...X.....X.X...X......X.X.
..XX..XX........X.....X..X..XX....X.X.......XXX.X..XX..XX..X...
..XX..XX...X.......XXXXX...X...XX...X....XXX....X...X.....XXXXX
..XX...X.X......XX.........X.....XXXX..XX......XX.X...XXX......
.....X...XX.....XXX....XX......X..X.....X.X....X..X....XXX.....
........X.....XXXX..X..X..X....XX.X..XX..........XX....X...XX..
XXXXX......X.......XX.XX......XXX..X.....X....X....XXXXX...XX..
..XX....XX...X......X.X....X..XX...XX....XX.X....X..........X..
.....XX.XXX....XXXX.....XX...XXX....X...XXX.XX.X...X....X.X.XXX
.XXXX....XX.X....XXX........XXXXXXX..X....X..X.X.....XX.X......
..XX...X....X.X...X...XXX.X..........X.X..XX.X.X..XXXX.....X...
X....X..XXXXX...X...X.XXX.X..X.....X...X...X...XXX.....X.XX....
..X..XX..XXXX..XX.........X..X...X.......X.XXXXX...XX..X....X..
.........XXXXXXXX....XX......XX....XX...XX........X...XXXXXXXXX
......X...XXXXXXX.......XX...X..X..XX....X..XXX.X...X.XXXXX....
......X.X.XX......XXXX..XX.X...XX....XXX.....X..............X..
.XXX....X.XX.XXX..XXX....X........XX...XX....X.X...X.X........X
.XXX...X..X..XXX..X...XX........XXXX...X..XXXX...X.X....XXXXXXX
.XXXX..X.XX.XXXX..X.....X.......XXXX.....X..XX........X.XXX....
......XX.XX.XX......XXX.X..XX....XXX....XX..XX....X..XX.....XX.
XXXX...X....X..X......X..X.XXXXX.X......X...XXX...X..XXXXXXXXX.
XXX..X...X..X....X.....X.......X....X.....X.X...X....XXX.....X.
..X...XX...X..X..X...X....XXX.....X......XX...XX.....XXX..XX...
......XXXX.X...XXX......X.....X....XXXXX.......X.....X..X....XX
...XX........X......X...X..X..XXXX..XXXX..XXXX....XX....X..X...
.XX.....X.XX..........XXXX...XXXX...XXXXXXXXXXXX..X.....XXXXXX.
.X...XX.X..........X.XX...XX..XXX.......XXX....X.XX.XXXXX......
...X.XX.........XX.X.XX.X.XXX.....XXXXX......X......XXXXX.....X
X....X...XX.....XX.X....X..X......X..X.....X....X.....XXXX....X
..X....X....X.XX...XXX.....X.X...XX....XXXX...X.......X......XX
.......XXX....X....XX....XX....X....XXXX....X.X..XXXXX..X.X..XX
.......XXXXX....X..XX.......X............X..X..........XX...XXX</walls>
			</board>