<?xml version='1.0' encoding='UTF-8'?>
<board>
				<level>185</level>
				<width>66</width>
				<height>64</height>
				<walls>.....X...........XXX...X....X.....X....XXXXXX......X..........XX..
...X.....XX....X.....X...XX.....X....X..X..XX....X........XXX.....
......X.....XX......X........X.....X.XX....XX..X..X.XX....XX...XX.
..XX..X...X...XXX.....X...X....X.X......XX..X..XX...XX.X.....X....
.....X..XX..X.....XX....X...X..X............XX.....X...X.XX..X..XX
..X....XX..XXXX...XXX..X...XXXX...X....X.XX..X.X...X.XX..X...X..XX
X...XX....XXX...X...X....X....X.X...X....X...X.XXX...XX.XX.X.....X
X...............XXX...XX....X...X...X......X...XX.....X........X.X
X.......XX...X..X....X...XX....XX.......X..XX..X..XXX...X......X..
XX....XXX..X.XXXX.XX....XXXX.......X....XXXXX..X...XX....XX...XXX.
...X....X.............X....XXXXX.XX..X......X....X..X..X..X.X.XX..
.X...X......X......X...XX........XX.X..XXXX.X.......X..XX...X....X
.......XXXXXX..XX..X.X.XX.X.XX......X.........X.XX......X..XX..XXX
XXX......X..XX.XXX...X....X..X...XXXXXX....X....XX.........XX..X..
X.....XX....XX.....X..XX.....XXX.....XX.XX...XXXXXXXX....X...X....
X...........XXXXX.....XX.X....XXX.......X...X..X......X....X......
X..X............X...X.X..X....XX..X...X...X....X...X....XX....X...
X..XXXXXXXX..XX..XX.X.X.XXX...X..XX.....XX..XX..X..X...XXX..X..XX.
X....XX..XX...XX....X...X...X...X...X..XXX...XX...X....XXXXXXX.XX.
..XX..X.....X.XXXX..XX......X..X..X.X......X.....X..X.............
...XX.X.........XXXXXX..XX..X..X.XX...X.......X....XX.........X..X
XX.XX...XXXX.XX.......X....XX....XX..XX.....X...X...X....XXX..X..X
XX..X.....XX..X..X....X....XX......X..XXXX..X..X....X.XX...X..X...
X...X..XX..XX....X...XX...XX...XXX....X.....XX.X.X....XXXX...XX.X.
..XXX...XX.....XXXXX.......X.X..X.....X.XXX......X.X............X.
...X..X.....X......XX....X...XX...X.....XX....X......X....X...X...
XX...XXXX.X....XXX..X.XX....XXX..X..XX..X..X..X...X.X..XX...XXX...
X...XXX...X..X..XXX...XX.XX...XXX..X......X..X..X.X..........X....
..X...X......XX......XXX......X...X..XXXX...X..XX........XXX...X..
.............XX..XXX...XXXX.......X.......XX..XX...........XX..XXX
XX...X.......XX...............XX..XXX..X..XX.X...X..XX..X...X.....
X..XXX....XX.XX..XX...X.......XX..XXX....XXX....XX...X....X...X...
X...XXXX..XX..XX....X...X......XXXXXX....XX...X.X..X...XX....XX.XX
..X......XXXX..XXX......X....X.XXX..X.....X.....X.....XXX..XXXX..X
..........X....X.....X.......X...X..X...X....X....X.X......XXXXX..
.XXXXXXXX...X.....X..X...X....XX.X..X......X.X....X......X.XX..XX.
..XXXX..........X...X....X..X..X.X.......XXX.X.......X...X.X...XX.
X.XXX..X.....XX....XX..........X...X......XX.X...XX..X..X..X.X.XX.
..X...XX.X....X..X.....XXXXXX..X..XX..XXX......X.....XX.X....X....
.XX..X...X.XX....X..XX......X......XX.......X......X.X.....XXX...X
...X.X.......X...X..XX..X.....X....XX..XX.......XX.X...X.X...X.X.X
XX.....XX......XXXX...X......XX.XXXXXX.......XXX.....XX..XXX...X..
X...XX..X...XX..X...X...XX....X.XXXXXX...X...XX......XX....XX..XX.
..XXXXX...X.......XXXX..XXXXX.....XXXXXX.X......X..........X...XX.
...X........X....X.....XXXX..X.XX..........XXX...XX.XX..X....X.X..
XX...X........X....X.....XX..X..XX......XX..X..X.XX.X...X.X....X.X
X....X.....X....X....XX...X...X..X..X..XXXX...XX....X.X....XX....X
X.XX.....X...X....X...X.X...X.XX..X.X.....XXX.....XXX....X...XX..X
..XX..X.........XX..X...XXXX......X.X...X.....X...X....X......XXXX
......X.XXX...X....XX........X........X....X....XXX.XX......X.....
XXXXX...X...XXX..XX.......XXX....X...X...X.....XXXX....XX.X..XX...
.......XX....X.........XX.....X....XXX.X...........XXX..X....X....
.......X...X.X.....X.XX..X......X.............XX...XXXX...XX...X..
.....XXX.X...XX....X.X...X.XX..XX....XX.......X..XXXXXX........XXX
.X...XX..X....X.X....X.X....X...X.XX......X.XXX.X..........X...XXX
.X..XX..XX..X.....X.......X...X...XXX.....X..X..X......X.....XXXXX
.XX.XX.XXXX.XXXX......X....X...X..X...XX..XX...XX..XXX.X...XXX....
.....X.......XX..X..X.XXXX...X.X..X...XXXX......XXXXXX...X.....XX.
XX.X...XXX.X....XX..X.XXXXX....X......XX......X.XX..XXX..X..X.....
XX.X.......XXX..XX..X.XXXXXXX.X.......XX..X...X.XX..X....XXX..XX..
...X..XX........X...X.XXXXX...X.X.....X...X..X..X...X..X..XX.X....
.XX....X.....XX...X...XXXXX.......XXXX..X.XX.X....X..X.XX.X....XX.
.X..XX.XX....X....XX..XXXX.....X....X..X..X.......XX.X.X..X.X.XXX.
...XXX....X..X....XX..XXXX.......XX...XX....X.....XX...X....X.....</walls>
			</board>