<?xml version='1.0' encoding='UTF-8'?>
<board>
				<level>101</level>
				<width>38</width>
				<height>36</height>
				<walls>XX......XXX..XXX...XXX...XXX....X....X
...X..X......X...X.X...X.XX..XX......X
.XXX.......X.....X.....X....XX...X...X
.XX..X.....XXXX..........X..XX.....X..
.XX.XX.XXXXXXXXXX.....XX...X.......XX.
....XX.XXX.....XX...X........XXXX.....
XXXXXX.....X......X....XX.X...XX..X.XX
..XXXXX......XX........XX...X....XX..X
............XXX...XX..X............X..
.XXX.....XX.X...X.......XX...X........
.......XXXX...X..X.....XX..X....X...XX
....X......X.....X.X....X.X...X.X...XX
......X.X..X...X.X...XX...X.....X.X...
...XX...X.XXX....X...XXX..XXXX..X.....
....XX....X...X..........X.........X..
....X..X..X.....X...X....X.X.....X....
......X...........XXX.X..X.....X......
XXXX.......X.....XX.......X.....X.....
..X..X.X.......XX...XX........X..XX...
....XX.X.XX.........XX...X.XXXXX.X....
.X.....X....XXXXXX.....X.X..X......XXX
.....XXX..X....XX....X......X.X.X..XXX
..XX...X..XX......X.......X...X....X..
.....X....X..XX.....X...X.....XX...X..
.XXX....X...XX.......XX........X...X..
...XX..........XXXX....XXX...X...X....
XX.......X.X...X....X......X..X..XX...
.....X...X...X.X.XX...XXX..XX.X.XX..X.
.XX......XX..X...X....X...X...X..X....
....X......XX....X.XX.X..XX....X...XXX
XX....X.....X.XX.X..X.XX.....X....XX..
X..XX.X...X...XX....X.XX..XX....X.....
X.X...XXX..XX..X..X...XX..XXX......XX.
X...XXX....X...XXX....XXX.....XX.X.XX.
....XX..XX...X..XX.X..XXX....XX..X....
....XX.....XXXX....X..XXX..X....XX..XX</walls>
			</board>