<?xml version='1.0' encoding='UTF-8'?>
<board>
				<level>259</level>
				<width>90</width>
				<height>89</height>
				<walls>X...XX...XX...........XX..X.....X......XX..XXXX........X....XXX...XXX..X...XXXX..XXX...X..
X.X.XX.X..X..XX...XXX.X...X..XX.X....X.....XX....X...X....X.....X.XXX..X.X..XX...X...X....
....X.....XX.X..X.XXX...X..X....XX.......X..X..X...X.XX.X.X.....X.X....X.XX....X........X.
.X....X....X...XX.....XXXX....XXX...X....XX....X......X.....X...X.X.XX.....XX.......XXX.X.
....XXXXXX..X...XX....XXXXXXX.X...X.X.XXXX...X.X....X.XX.X......X...XXX.........XX...X....
XX....XX..X...X....X.....XX...X..X..X......X.X.XX.....X..X...X..XX..XX..X...XX.....X...X.X
X..X........XX..X..X.....XX....X.X...XXX...X...X..XX..X...XX.XXXXX..XX..X.......X..XX....X
..X..X...XX..X.....X....X...XX.......X...X..X....XX....XX....XXXX....X........X..XXXXXX...
.XX....X..XX...X...XXX....X.......X......XX...X.....X.....X..XXXX......X.......X..........
.XX..XX...XX..XX.XXXX..XXXX..XXX....X....X..XXX...XXX.X.X...XXXXX...X....XXXXX..X.........
.XX...X....XX....X....XX..X...XX...XXXX..X........X.....XX....X...X......XXXXXX...........
.X..X.XXXX....X..X........X.X..X........XX...XX..........X.X....X....XXX.........XXX......
...X..XX...X........XXXXX...XX....XX....X..XX......X.....X...XX....XXXXXX......X.....XX...
..XX.XXX.X.XXX....X....X...X....X....X..X...X..X.....XXXXX..X....X..X...X..X...X..X..X....
..XX.....X.XX...X.X..X...X...XX.....XXXXXXX....X.XX.X....XX....X.XX...X.XX...X..X...XX.XXX
..XXX....X..X.X...X..X....................XXXX...X..X.XX....XX.X.X......X.......XX.....XXX
XX.....X.XX.X.X..X......X....X.....XXXX.....XXX..X......XX..XX.X.X........X........X....XX
...X.X.X..X...X....XX.X...XX.....XXXXX..........X....X..XX..XX...XXXXXXX.......XX....XX...
.XXX......X.......X...XXX...XX....XX...X...X......X....XX..XX......X...X..................
......X.X...XX.XX...X...X.X....XX....XXXXX...X......X..XX.....XX...X.X.......XX.XX..X.....
XXXX..X........XX..X..X..................XX..XXXXX....XX..X....X..X..XXXX..X..X...X...X...
.....XX..X...XXXX..X.X...XX.....X...XX...XX......X.....X....XX.XX.X....XXXXXX...X.X.XX....
..XXXX...XXX..XX.....X.X....X.X...X.X..XX...XXXX.....X......XX.........X..........X.X..XXX
X......X.X..X....XX....X.X....X..XX.X.XXX....X....XXX...XXX......XXX.....XXXXX......X.X...
...XX..X....X....XXXX......X.XXX..X........X.......XX.X...XXXX.............X........X.X...
.X..X.......X.......XXX....X...XX.XX.X.....XXXX....X..XXX..XXX....X.X...XX...XXX....X.XX..
..X..XX.....XX..X...XX.......X....XX...X..XXXX..X....XXX...XXXXX..X...X...X......X..X.X...
X...XX....X.X...X.XXXX....X............X...XXX....X..X...XXX.....X.....XX.....XXXXXX..X.X.
XXX.X..XX...X.X.......XXX...X.X......X...X.....X..XXXX.....X..X....XXX............X..X..X.
......X.......XX.X......XX....X.XXXX....XXXX.......X.....X..X...X...X...XXX..X....X....XX.
.X.........X..X..X.X.......XXXX.......X.XX.........X.XXX.XX.XX..XXX...X....X...X....X.....
...XXX...X....X......X...X..XXXXX..XX...X..XX....XX..X....X....XXX..XX...X.X..XXXX....XX..
.....XXX....X.XXX.X..X......XX.....XX..XX.X...X...X.....X........X.....X...XX......X...X..
..X..X..X...X.XXX...X....XX......X..........X...X.....X....X.......XX.......X..X...X.X....
XXX.XX....X...........X.....XXX......XXX.XX........X..XX.X...XX.X...X..XXXX.XX...X.....XX.
XX.....XX....X...XX.....X.X..X..X....XXX.........X...XXX....XXX...X..X....X..X..XXX....XX.
...X......XX...X..X....X..XX...XX...XXXX..XX.XX......XX...X........X....X.XX..X.....X.....
.XX......XXXX.....X..X.X....X.......XXXX..XX....XXX.....XX...XXXXX.XX.X...X...XXX.....XXXX
....XX........X...XXXX....X....X......XX...XX..XXXXXX....X.X...XX..XX.....X....X..XX....XX
X...XX.XX.XXXXX.X...XXXX.....X.....XX....X..X..........X.....X....X....X.....X...XX.....XX
..X....XX...XX......X....X....X..XXXXXX...X...XXXX...............XX.XX.....X......X.X.....
.X.....X..X....X......X....XX....X......X....XXX......X.......X.....XX..X.....XXX...X.XXX.
.X.....X......XXXXXX..........XX.....X.....XXXX...........X.X...X.X.....X.X...XXX..XX.XXX.
......XX.X....XXXXX....X..X.......X....X........X....X.XX.X.....X.....X.....X...XX....XX..
X...X....X.X..XXXX..X...X...XX.X....X........X..XXX....XX..X.......XX.XX.XX.....X..X..X..X
..X....X.....XXXXX....X......X...X....X..X.....XXX..XXXXXX...X.........X..X..XXXX.X...X...
.XXX.....XX.....X....X.....X.......XXX...X..X...X..X..XXX............X....XX....X.X.......
.....XX..XX...X.X.XX.X.....XX.....X....X.XX.X.X.X.........X...XXXXXXXXX.......X.....XX.XXX
X..X.XX.....X.....XX....XX....XXX...X..X......X....XX....X..XX.....X....XXX.X.XXXX.....XXX
...X....XX.....X.XX...X....X..XXXXXX...X...X.....X....XX...X...XXX.X.X..XX..X.XXX..XXXXXXX
.X....X....X.X...X..X.X..X.X.........X...X.....X....XXX..........X...XXXXX....XXX....X....
....X.X.X..X..X....X..X......X......XX..XX..X.....X.........X........XXX.......X..XX......
X...X......XX...X..X....X...XX..XXX......X..X...X...XX.X....X...XX...X...X.....X..X...X...
X.....XX...XXX..X.........X...X....XXXXX....XX.........X.X..X.X......X.......XXX....X...X.
...X.......XX..XX...X.......X....X.....X..X..X...X............X.X......XX.XX.....X......X.
.X...X.....XX.....XX.....X..XX...XXXX..X..XX.........XXXX..............X..XX.......XXX....
....XX....XX..X....X.X.X.XXX...XX.....XX......X...XX........XX...X.......X.........X..XX.X
X......XX.XX....XX.....X.X...X.......XXX...X....XXXX..X..X.......X..X.......X......X..XX..
.....XXXX.........X.X....X.....X.XX..XX..X...X...XXXXXX..X.X.X...XX......XX...X....X......
.X...XXXXXXXXXX.....X.X..XXXX....X..XX..XX.XX....X.......X.X...X..XX..........X....X...XXX
...X..X...X..XX..X............X....X...XX..X..XX.......X........X.XX..XXX............XXX..
XX....X.X....X...X.X...XX...X........X....XX........X.......X...X.XXX.XX...XXX.XX...XX....
XX.........X...X.....X..X.X....XXX.....X...X....X.....X.....X..XX.XXX....X.XXX..X.X.....X.
...XXX...X....XXX.......X....XXX.....XX..X...XX...XX....XXX..X....XXXX...X....X.....X.X.X.
.XXXX....X..X...X..........XX.....XX....XXXXX.....X..X..XX...X.....X...X.XX...XX.X..X.....
....X....X..XXX...X.....XX..X.X...XX.....X..........XX.XX..X...XXX.X..XX..X.XXXX...X..XX.X
X........XXXXXXX..X.XXX...X.....X.....XX.....X...XXXXX....XX.....X..X...X..........X.....X
..XX......X......X..XXXX.....X....X.X..........X...XXXX.......XX.XX..X.....X....X....XXX..
.XX..XXXX.X.....XX.......X.XXX.X..X....XX...XX.....X......XXX..X.....X.X.X...XX...X...X...
..X....X..X..XX...XXX...XX.X...X..........X..X.........X.....X....XXX..X.....XXX...XX...X.
X...XX...XX....X..X...X....X.XX..XX...XX..XX........XX...XX..XX...XX..X......X...X.XXX....
X..X....XXX....X.X..XXX......XX......XXX......X.....XXX.....XX..X....XX......X.........X..
...X..X..XX........X....XXX.....XX.X.XX....XX...XXX.X...XX..XX....X.....XXX.......XXX.....
.X..X..X....XXX.XX.....XXXXXX.X.XX...XX.........XXX........XX..X..X.X.....X...X.........X.
.XX..X.......XX.....XX..XX..X........XX...XX........XX...X.X..X..XX.........X...XXXX.X..X.
..XX....XX..........XXX.XX..XX.XXXXX....X...XX.XX...X........XX.XX..XX...XX........X...X..
X.....XX....X.........X..X...X...XXXXX...X..XX.....XX...X...XXX..X...X.......XXXX.....XX.X
XXXX......X.........X.XX...X...X..XX...X...X.....X.....XX...X..X...X...X...X......X.X....X
.......XX....XXXXXX.X.....XXX.....X..........X...X..XX.X..XXX..X..XX.....X.XX..X..X....X..
....X......X..........X....XX.X.X...X...XX..XX.X.XX......XXX...X..XX....XX..X...XX...XX...
X.....X......X.....X.....X..X...X..XXXX...XX.....X..XXX......X..X.......XXX.X.X..X....X.X.
...X....X......X.....XXX....X....X......X....XX....XXX......XXX.....X....XX...XX....X.....
.X...XXXX...XXXX..X.......X....X............XXXXX..XX..XXXX.X....X..XXXX.XXX......X.XX...X
....XXX...X..XXXX....XX.XX...X.........X.X........XXX....XX...X....XXXXX..XX....X.X..XXX..
..X..XX.X....X.....X..X....X..XX....X....X.X.X....XX...X........X....X....XX..X.X.XX..X...
..XX....X..XXX...X..X...X..XX..X....X.X......X...XXX.X.....XXX..X.XX...XX..XXXX.X...X...XX
...X..XXX...XX...XX.X...XXXX...X..XXX.XXX...XX...XX..XX....XXX..X..........XX.......X.....
.X.X...XX.X..X....X.X....XXX......XXX..XX...XX....X...X.XXXXX.....X...XX...XX..X........X.
...X...XX....X..X...X..X..........XXXX....XXXX..X.....X.......XXX...X......XXX.......XX...</walls>
			</board>