<?xml version='1.0' encoding='UTF-8'?>
<board>
				<level>137</level>
				<width>50</width>
				<height>48</height>
				<walls>.......XXX...XXX...XX....X.......XXXXXXX..........
.....X.XX..XXX...X.XX.XX.....XXX.XXXXXXX.......XX.
X....X.XX.X......X....XXX.XX.....XXXXXXX..XXX..XX.
X.X.....X....XX..XXX..XXX.X...X...XXXXXX..X...XX..
....XXX....X............X...X.....XXXXXXX........X
.X.......X..X...X...X..........X..XXXXXX..XX...XXX
....XXXX....X.X...X......XXX......XXXX...XXXXX.X..
..X...X...X...XX..XX...X...X....X.XXXX.......X....
XX......X.....X...X....X...XX.....X.....XXX....XX.
...X.....X......X...X...X..X...X..X...X.....X.....
..XXXXXX.....X.XX.....X.X..X.X....XX..XXXX....XXXX
X...XX....X..X..X...XXX....X.XX...XX.XXXXXXX.XX...
X......X....XXX..X..X....X...XXXX..........X......
X........X..XX...X.XX.XX.........XX...X........X..
X....XX..X.....XX..X..XXX....XXX....X...X.........
XX.......XXX......XX....X..X......XX........XXXXX.
XX.XX.XX...XXXXX...XXXX..X......X....X...XX..XX...
...X..XX.....XXX.X.....X....XXX...X..X...XXX....XX
.XXX...X.......X.X..XX....X..........X...XXX.....X
.....X.X....XX...XX...X.....X..X.....XXX...X..XX..
..X....X..XXXXXXXXX.X....X..X......XXXX..X..X.X...
..X.X...X..XX..........X...XX.X....XXXX.....X...XX
XX..XXX....XX......X.XXX......X...XXXXX...XX.....X
...XXX...X.....XX..X........X.........X......XXX.X
..X....X.......X..XXXX..X.X...XX...X..X...X......X
X...XXXX..XXX....XXXXX..X.....XX.X...X..X...X.....
...X...XX..XX...X....X...X.....X.X..XX............
.X...X.....XX.....X....X.....X.X..X.X..X...XXXXXXX
..X..XXXXX.....X..X.X.XXXXX.......X.X....XX....X..
X......XX....XXX..X.X.....X.X.X.....X........X....
X..XXX....XX......X...XXX...X..............X...XX.
...X....XXXX...XX.......XX...X.X.....XX...........
.X....X...XX......XX.XX....X.X...X.XX.........X...
....X...X..X..X......X.......XX..X.X...X....X...X.
..XXX......XXX...X.....XXXX........X.X....X.......
..X......XXX...X...XX..XXX....X.........X....X...X
.......XXX.....XX.....XXXX.........XX......X.....X
..XX...X...XX..X..X..........X.XXX....XX...X..XX..
X....X...XXXX....X..XX.X.....X..XXX...X....X......
X.......X.....X....XXX....X.....X.....X......XXXX.
..XXX.X.X.X...XX..XX..X.X...X.....XX........XXXX..
.XXXX.....X.XXXX..XX..X..X.....X.....X.X.......X.X
...X...X....XXXX...X.....X.X.X.XXX.....X.X...X...X
XX...XXX...XXXXX.X...XX......X...X..X......X.X..XX
....XXXX.......X....X....XX.XXXX.X......X....X....
.XX.X..X..XXXX.XX......X.XX......X...X....X.......
..X....X....XX.X.....X.....X....XX.....X....X.XXXX
X......X....XX...XXX....XX...XX..........XX...XXXX</walls>
			</board>