<?xml version='1.0' encoding='UTF-8'?>
<board>
				<level>133</level>
				<width>48</width>
				<height>47</height>
				<walls>...X....X..XXX............XX..XX..X.............
.X...XX.X....X.XX.........XX...X....X...X...X...
.XXXX...X.X..X.....X...X..X..X...XX...X.....X.XX
......XXX.X.X....X.X.X..XXX.XX........XX.X..X.XX
X....XXXX.X...XXXX.X.XX...X.XX.....X...X....X..X
..XX..XXX.......XX...X......XX..X....X...XX..X..
.XXXX..X.....XX.XXX....X.....XX...X..........XX.
.......X........X.....XX.....X..XXXXX.....X.....
XX...X......X............XX..X.X.....XX...X....X
XX.X..........XXXX...X.......X...XX.....XXXXX..X
...........XX.XX...X.....X...XXX....X.XXX.....XX
.XX.........X....X........XX...X.X..X.......XXXX
.XXXXXX.....X..X...XX...X....X.....XXXXX........
......X......XX.......X.XX...........X.....X....
X.......X.......X...X.X..X..X.XX..X....XX..X.X..
X...XX.......X....X.X....XX.X..XX...X...XX.....X
X........XX....XX...X..XX...XX......XXX.........
...XX....XX.X...XX...XX........XXX......X.....X.
.X....XX........XX.....X...XX..XX..XX...X...X...
.XXX...XXX...XXXXXX........X..XX..XX......X.....
.....X....XX....X.......XX...XXX.....X.......X..
X....XX...X...X.......XX........XXX....X...X.X..
X.XX....XXX.X...XX.....X.XX.XX....X.X..X.XX.....
X....X..XX..XXX.X....X...XX.XX.X....X.X..X..X...
XX...X..XX.X......XXX.......X....XX...X....XXXXX
.......XX..X...X......X...XXX.X........XX......X
.XX.....X...X....X......X..XX.XXXX...X....X....X
..X...X...X...X....XXX..XX.X..XXXXXX..XXX...X..X
X..XX.XX..XX....X.......XX...X....XXX.....XXX..X
XX.XX.XX.X...XX...........X..X.........X...XXXXX
XX....X....XXX...XXXXXXX.........X.XX....X......
XX..XXX.X......X.X..XXXX.XXXX..X...X..X.....X...
X...X........XXX....XX....X....X..XX.X......X.XX
..X......XX....XX...X...X....X..X..X...XXXX.....
.X.....X....X....XX.X.X..X.X.XX....X.....XX..X..
...XXXXX...XX.XX.XX...XX.X...XXXXX....XX.X...X.X
.....X........XX.......X..X..XXX....X.XX...X....
.XXX........X.....XXXX....X..X...XX.....XXXXX.X.
.XXXX.............X.....XXX..X..........XX....X.
.XXX.........X..XXX...X..X........XX.......X....
...X......X.....XXX......X........X..X.XX....X..
....XXX.....X...X....XX...XXX....XX....XX.X..XXX
..X......X..X...X....XX.X..X..X.....XX....X.....
XXX..XXX.....XX......X.....X....X.XX...X....XXX.
XXX..X....XX....XX...X.X.X..XX....X....XXX...XX.
XXX.....X..X..X..XXX...X....X..X....X..XX....XX.
XXX...X....X..XX............X....X..XXXXX.......</walls>
			</board>