<?xml version='1.0' encoding='UTF-8'?>
<board>
				<level>191</level>
				<width>68</width>
				<height>66</height>
				<walls>....XXX..X......XXXXXXXXX..XX..XX..XX...X.......XX.......XX...X.....
....XX...X...XX.XXXXXXX....X...X...X..X....X..X..........XX...X...X.
X...X..X..X.....X.......XX.X.X...X...X...X.X....X........XXX..XXX...
..X...XXX...X..........XXX.....XX......X.....XX......XXX......X....X
.XXX.....X.....X...X........X...X.....X...XX.....X......X...X...XX..
.XX..........X.X...X....XXX...X.X...X...X.X..X...X..X.....X.XX..X...
..X.....X.XXXX...X......X.........X.XX....X.XXXX..X....X..X.X.....XX
X...XX....XXXXX....XX......X..XX....XXXX....X.....X.XX....X...X.....
X....X.....X......X......X.X....XX...XXXXX..X...........X....XX.XXX.
X..X.....X.X.X.X....XXXX.....XX....X....XXXX.......XXXX......XX.X...
XXXXXXX..X...X.X.X...X....XX..XX......X.XXX..XX..........XXXXX..X.XX
........XXXXXX...XXX......X...XX..X...X.....XXX......XXX...X...X..XX
.XXX...X........XXX...X...X.X.XXX.X...XX....XXXXX....XX....X...X....
...X.X...XX...X.....X.....X.X.......X..X..X..XX...X.....XX.....XXXX.
...X....X...X....XX.......X.....XX...X..X.XX.XX.....X....X.XX.......
......X...XXXX.X........X.XX....X..X.XX.X.X..X.........X......X.....
..X..........X.X.X...X....XX..XXX.......X.X....X.....X......X...X...
..X...XX.X...X...X...X.X...XX.......XX.......XXXXX.X....XX.....X..X.
..X....X........X....X..XX.....XX......X...X..XXXX.X..X....X.X.X....
.....X....X...X...X...X......XXXX.XXX..XXX..X..XXX.XX.XXXXXX.....XXX
...X....X.X...X..XX.X.X..XX............XXXX..X...X..X.......XXX...XX
XXXX..X...XXX.X.....X..XX........X.XXX.....X..X.....XXX...X...XXX.XX
......X.XXXXX...XX..XX.X...X.....X.XXXXX...XX.X.X.......X......XX.XX
..XXX...XX...X......XX...X.X.XX..X..X....XXXX.X.X....X....XX.X..X...
X....X...X.X.XXX.......XXX...X......X.X.......X...X..XXX...X..X...X.
XX.....X.X......X..X.X....X..X............XXX....X..XXX..X....XX..X.
XX.XX.......X...X..X....X......XXXXX...XX......X...XXXX.XXXXXXX..X..
...XX..XX......XX.....XXX........X...X......XX........X..X......X..X
..XXX.....XX.X..X...XXXXX.....X....X.....X..X.....X...XX.....X....XX
X.XXX...X.XX..X...XXXXX....XX...X...XX.....XX.....X.XXX...X....X....
....X...X.....XXX...X....X.XX.....X..X..........X...XX..X...X....XX.
.X....XXX.......X.X....X.X.....X..XX..X.....XXX.....XX........X.....
.X...X..X.....X...XX...X.....X....XXX...X........X..X..X...X....X.XX
.X......X..X.....XXXXX....XX....X.X.......XX...X...XX....X.....XX..X
......X..XX..X.X.....XX...XX.XX.X...X.....XX.X.....XX.XX....XX...X.X
..X...XX....XX.XX....X..X....XX....XX.XX.....X..X.....X.......X....X
.....XXXXX.....X....XX....X....X....X.XX...XX...X.X...........X.X...
...X....X..XXXXX.X.....XX.XXX.....X......XX...X....XXX.X......X..XX.
XXXX....X...XXXX...XXXX.......X......X....X..X...X...X......X.XX....
.......X....XX....XXXX...X.......X.....XX..X.X.X........X...X.....XX
....X....XXX......XX...X.......X.........X...X....X.XXXX......X....X
..X...XXXXXX..X...X....XX.XX...XX.....X..XX.....X.X..X...X......XX..
..X..XXXXXXXX.X.X...X..X..XX.X..X...X...X.....X...XX.....X...XX..XX.
..XXXXX..X......X...XXX..X......XXX.......XX..........X....X...X....
X..XX........X........X....XX....X...X.......X.....XX...X....X....XX
...X......X......X.XX...X......X...X...XXXX..X...X........XX....X...
.X...X......XXXX...XX.....X....XX......XXX..X....X.X.....XX.......X.
....X......XXXXX..X....X....X..X..X.XX.XXX....X....XXX.X.......X..X.
....X....X........X..X....XXXXXX..X..X...X......XXXXXX.......X.X..X.
...XXXXX........X..X....X............XXX.XXXXX......X...X..X......X.
..........XXXX..XX....X....XX....X....XX..XX...XX...X.X....X.XX...X.
..X.....X......XX...X....X....XX....X.XXX....XX...XX..X.XX.X.XX..X..
..X...X.......XXX.X...XX...X..X...X.X....XXXXX.......XX.XX...XX..X.X
..XXX...XX.X..X...XX..XXX.....X.......XX..X....X...XX....XX..XX....X
XXXX....XX.X.XX....X.X..XXX........X...XX...X..X....X..X.XX..X..X...
.....X...X.........X.X.......X.XXX.X.X....XXX..XXXX....X.......X..X.
..X....X....XXXX..XX...X.....X.......XX...XX...XXX...X....XXX....X..
X.X...XXXXXX......XXX..X..X..X....X.XX....XX...XXX...XXXX.....XXXX.X
X.XXX....XXX....X..XX..XX.XXXX.XX...XX.X..X......X..XXXXXXXX.......X
..XX.....XXXX....X.XX..X..XXX..XX........X..X....X....XXXX...XX....X
.X...X..X......X.X.....X.XXXX.......X.XX.X......XX.......X....X..X..
....X...X....X.......X.....X.....X....XX.....X..XX...X.....XX..X....
X.X...X..XXX.XX...XX....X....X.....X....XX.....XXX......X....X.XX...
.....X...X...XXXX..X..X...XXXX....XXXXX.......XX...XX.X.X.X....X..X.
.X.X.X.....XX...XX..XXX.....XX..X.X...X...X.X..X.X..X.....X.X....X..
...X..........X.....XXX.....XX..X...X...X...XX...XX....XXXX........X</walls>
			</board>