<?xml version='1.0' encoding='UTF-8'?>
<board>
				<level>173</level>
				<width>62</width>
				<height>60</height>
				<walls>XX..X..XXX...XXX......XXXXX...X..X...XXXXXXXX....XX....XXXXXXX
XX..X......X...X.XX.......X...X....X.X.........X.XX..X.....XXX
XX..X...X...XX...X..XX.X..X..X..XX...X....XX.X.X...X.....X.XXX
XX....X...X.XXX....XX..X.XX..X........XXX..X.......XX.........
...XXX..XXX..XX...XXX.....X........XX.XXXX......XXXX..X...XXX.
.....X.XX....XX......XX.X...XX........X.....X...XXXX.XX...XXX.
XXXX....X.X...X..X...X..X.......X...XXX.XXX.X.X......X........
XX....X.X...X.X..X.XX..XX.....X...X..X..XX..X....XXXXX.....XXX
...XX.......X.X..X.XX...XXXXXXXXX.XX...XXX...XXX........X.....
.XXXX.XX....X....X......XXXX..........X...XX..XXX...XX....XXX.
...X.....XXX...XXXX......X.......X.X....X.X...X...X..X.X.XXXX.
XX...X.X.X...XX........X...XX.XX...X.X......X....XXX...X......
..X....X...X....XX.X....X..XX..X..XX...X.XX....X...XX..X.....X
....X...XXXX...XXX....X...X....X..XXXX.X.....X........X..X...X
.XX...X..XXXXX.X...XX.......XX...........X.X.XX.....X.X.XX....
.XX....X....XX...X.X.....XXX..........X....X.XX.....X...X...X.
.XX..X......XXX..X...XXXX.....X....XX...X......XX...XXXXX.X...
.X......X........X..XXX.....X...XX..X.....X.X.....XXXXX...XX..
...XX...X....XXX..X..............XX.....XX..X.X.X........XXXXX
X.....X..XXX...XX...XX.....X...X.X...XX....XX.X........X.....X
....X....X.....XXX..X....X...X.X...XXXX..X..X....XX....XX....X
......XX.X.XX.......X.XX.....X....XXX.......X..X.....X..X..XXX
XXXX..XX...XX.......X....XX.......X......XX..X...X.X.XX..X....
XX.........X......XX.....X....XX.....X.......X..XX.X...X..X...
X..XXX.....X.XXX.....XXX.X.......XXX....X.....X..X........X..X
X.XX.........XX..X....XX.XXXXXX..X....X...XXX..X....X...XXXX..
X.XX.XX...XXX...XXXXX....XXXXXX....X.......XXX....X.X.XX..XXX.
X....X..X.....XXXXX...X..XXX...XX....X...X......XXX.X.XX..X...
.....X.....X..X..XX.X.....XX.X...XX..X...XXX........X.....X...
.XX....X.....XX..X..X..XX.X..X...X.....X...X.......X...XX.....
.XX.X.....X...X....XX...X...X......X...XXX.XXXX..X...X...X....
........X.X.X...XXX...X.XX....X..........X..X....X..X......X..
XX...X......X....XX.....XX...X......X.X..XX....X....X.X.XX.X..
XX...X...X.....X.....XXXXXXX.X........X.XX...X....X.....XX.X..
XX....XX.....X...XXX.......X.X..XX.........XXXX......XXXXX...X
...XX...X.....X..X..X....X...X.....XXX...XXXX.................
.X...XX.....X...XX....XX....X..XXX.X...XXXXX.......XX.......X.
.X.......X...........XXXXX....XXXX...XXXXX...X...X....X...X...
.X.........X.XXXX..X.....X.X...XXXX...XX....XXXX..X...X.X.....
.X.....XX..X..X....X.XXX.......X....X.....X.....X...X......X..
.X..X......XX...XX...XXX..X......X..X...X.......XX.....X.X.XXX
.XXXX.X.......XX..X..XXX...........XX.X.XX.....XXX.XX....X....
..XXX.X...X.X.XX......X..XXXXXXX......X..X...X.....XX.X...X...
X...X...X.X....X.X......XXXXXXXX..X..XXX.....XXX..........X...
....X........X...X.X......XXXXXXX....XX...XXXX...X..XX.XX.....
...........XXXXXXX.XXXXXX.XXXXX...XX....X..XX....X...X.....X..
XXXX.XX..XXXXX.........XX.XX.....XXXXX...X....X....X.....X.XXX
..XX.....XXX.....XX.......X..X.X.......X..........XX..X....XXX
.....X...X.......XX...X.....XX..X....X....XXXXXXXXXX..X..XXXXX
.XX......X.XX.......X.........X.X..X...XX.....XX..XXX..X......
....X......XXXX...X....XXXXXX.X..X.XX....XXXX.....XX...XX.....
...X....X..XXX..X....XX..X.......X.X.......X...XX....X........
.X...X.....XXX....XX.....X.XXX.....X.X.....X.X...XX...XX.XX...
.X.....X...XX......X...X........X..X.........XXX....X.XX.X....
.....XX.....X.XXXX...X....X.....XXX...X...XX......X......X.X..
..X...X.XXX.X...XXXX....X.......X...X...X.......X....X.....X..
....X...X.......X....XX....XX...X......XX.X.X...X..X....X..X..
...XX..X.....X....X....X...X......XX...X....X.X....X..X...X...
....X....X.....X..X.X......X.X.......XX..X.........XX.......X.
XXX...X..XXXX..X..X...X......XXX........XXXXXX........XX......</walls>
			</board>