<?xml version='1.0' encoding='UTF-8'?>
<board>
				<level>44</level>
				<width>19</width>
				<height>17</height>
				<walls>...................
.X.X....XX......XX.
.X....X.XX....X..X.
....X.X..XX...XX...
X.....XX.X.........
...X.....X.X...XX..
.X.....X.....X..X.X
.X..X.....X...X....
.X....X.X...X....X.
...X....X......X...
X..XXX.......X.....
...XX..X...X.XX....
...XX....X...X.....
..XXX........X.....
....X........XXXX..
.XX...XXX....XX....
..........X..XX....</walls>
			</board>