<?xml version='1.0' encoding='UTF-8'?>
<board>
				<level>273</level>
				<width>94</width>
				<height>94</height>
				<walls>......XX..XX........X...X..XXX.........X..X..........XXXX..XX...XXXXXX...X.....X..........X...
...XX.X...XX......X...X....XXX..XXX..X....X........X.X.....XX.X.XXX....X.......X.X......X...X.
...XX...X.X...XXX....XXX...XXXX...X....XX....XX......X.X...X....X...X..XX.XX...X...X....XX....
.......XX...X..XX..X.XX....X......X.XX.....X.XX..XX....XXX...X.........XX.X..X....X..X.......X
..XX......XX...XXX...X..XX...X....X.XX.....X...X......XXXXXXXXXX.....X....X.X...X...XXXX.....X
X.....XX..XX....XX.XXX......X.......X....XX..X.X..X..............X...X......X.XX....XX...XXX..
..XXX....XX...X.XX........X.X......XX.X...X....X..X.XX.XX..........X........X....X..X..X......
.XXXX...XXX.X.X.....X.....X.X..X....X...X...X..XX......XX....XX.......XXXXX...X.......XXX..XXX
......X.....X.XXX.XXX..XX...X....XX....XX..XX..X.....X..XX...X....XX...X........X.XX.......X..
X........XXX....X...XX.....XX.XX.....X..X..XX..X.X.X....XX..XX.......X...X...XX.X..X.....X....
..XXXX.X.....X......X.........XXXXXX....XX.....X...X..X...X.......X..X..XX.........XX....XXXX.
.XXX...X.XX..X...XX...X...X......XX.....X..XXX....XXX...X.X..X....X..X.......X.X....X...XXX...
.XX..XXX....XX.X........X......X....X.....X..XXXX...XXX...XX...X.....X.XX....X......XXX.....XX
....XX..XXX....X...X...XXXXX.....X..X....XX......XX.XX...XX......X.X.X.X..X.....X...X....XX...
X...XX..XXXXXXXXX..XXX.....X.XX..X..XXX..X..X....XX....X....X.X..X.....X.X....X...X.X..X....X.
..X.....X.........XXXXXXXX....X....X..X..X.XX...X...X....X....X.X...XX...X.XX...XX..XX..XX..X.
.XXXXXX.........XX.....XX...X...XX.X..X....XX.....X.X........X....XXX....X......XX.XXXX.X.....
.X.....X.X...XX....XX.....X......X.X....XXX......XX...X......X.X...XX.X....XXX.....XX.....XXXX
...XX..X...X.XXX...XX.X.......XX.X...XX........X..X........X.X...X.....XX.....XX....X.XX.X....
X.....X....X...X.X....X....X..X..XXX.......X.X....X..X.....X.........X....X.....XXX....X...XX.
X.XX....X....X.X..X..X..X.....X.XXX..X.X...X......XX...XX.........XXXXX...........XX.X.....X..
..X....XX.X....XX.X....X..X.X...XXX.X..X......X...XX..XX..X.....XX..X...XX.........X....XX...X
.XX.......X.X...X...X....XX..XXX......X...XXX...X..XX.XX......X.....X..XXXXX.....X..X.......XX
.......X..X...X.XX....X..XXX......XX....X..X.......XX....XXX..XXXXX..X...XX..X....X..XX...X..X
..X....X......X.XX..XXX..XX.....X.XX...XXX...X............XX.XXXX....X....X.......XX.X..X....X
....X....X....X..XX.XX..XX..XXXXX..X.X.....XXXX..XXX....X.........XXXX..X...XXX...XX...X...X..
.X....X...XXXXXX.....X...X....XXXX...XX......XX...XXXX.....XX.....X..XXXXX..XXX.X.....X..X....
...X....X........X.X...X...XX....XXX....X.....X.X......X...XX...X....X......X...XXX...X.X.....
..XX.X...X.........XX...XX.X.....X...X..X...X...XX............X....X...XXXX.....X...X.....XXXX
.......X....X.....X...X..X...X.......XXX..XXXXX..X..XX..X...XXXX......XXX..X....X......XX...XX
....X.....X.XXX.......XX....XX..XXX..XXX.X.......XX.XX....X.......X.....X.........XXXX..X.X..X
..X...X.....XXX....X......X...X...XXX..X.......X.......XX.XX....X.........XXXX......XXX...XX.X
.....XX....XX...X..X.XX...XXX.....XXX.....XXX......XX...X....X..XX.......XXX...X.X....XX.....X
.X.X...X...XX.XXX.X..X....X...........XX......X.......X....X...XXXXX...X.........X.X.......X..
...X.X.....X..X.....X..X..X......XX......XXX....XXXX.......X.XX......X...XXXX...XX...XX.......
..XX....X..X.....X....XXXX....XX..X...X....X.XX......X.XXXXX....XX........X...X..X....X...X...
..XXX.....X....X.XXX.......XX.....XXX.XXX..X..X..X.....X..XXXXX.............X....X.XX..X..XXX.
XXX.........XXX..XXX.XXXX......XX..XX.........X..X..X.....XXX.....X......X.....XXX.....X.XXX..
.........X....X.X..X..XXX....X..X..XXX....XX.....XX....XX.X........XX.X....X....XX..X......X.X
.XXX.....X.XX...X.....X..X...XX....XXX.XX....X...XXXXX.X..X.XX...X.XX...X.......X.....X.XX...X
.....X.XXX......X.XX.....X.XXXXXXX..XX......XXXX..X......XX..X.XXX........XX..........X.....XX
XXXX...XXXX.....X.XX...X...XX..XX...XXX.......X...X.XXX....X.X...........X.....X.X.......XX...
......X...X..X..X...X......XX.....X........X....X.....XXXX...X....X..X......XX.X...X...X......
....X...X.XX...X....X.X....XX...X...XX...X...XXX......XXXXX....XX.X....XXXX..X.....X......X...
X.......X..X.....X....XXXXX...X.....XX...X..X....X.......X....X.....XX.....X....XX.X....X...X.
..XX.......X..XX...XXXX...X.....XX.......XX...X..X...XX....X....XX...XX....XX...XX.X.X........
.XXXXXXX......XX........X..........X.XXXX.....X....X....X....X.....X.....XX..XX......X.X.....X
.........X..X.....X..XXXX..XXXXX...X..X....X..XXX....XXXXX..XX...X.....X..X...XX..X......X...X
X........X...XXXX....X.....X......XXX....X..XXXXXXX..XX..X.....XXX..XXXXX...X..X....X........X
..XXX..XX..X....XXXX.....X......X.X...XX..X.X.........X....XXXX............XXX...XX...X.......
.X..X...X...X.........X...X.X...X.X...XXX.....XX..XXX...X.........XXX...XX..XX.............XX.
.X..X.X.....X....X......X...X.X...X..XXX...XXX....X....XX...XX.X......X.X...XX.XXX...X.....X..
.X....XXXXX.........XX............X......XX....XX....XXXXX.....X.X........XXXX.....XX.....X..X
...XX.......XX..X.X...XX.....X....X...XXXX....XXX..X.......X.......XXX.X.....XX...X...X.X.X...
X..........XXXXX..X....X.XXX.....XX...XXXX.X....X..XX...X.....X......X.X.XXX.X..X.X.....X.....
X.XX.X.....XXXX..XX..X...XX...XX..X...X......XX.X.....X.....X...X.X..X.X.....X.XX....XX..X....
.....X....XXXXX.........X...X..XX...X.....X.XXX...XXXXX..X..X.....X.XX.X..X.....XXXX.....X..X.
.X......X.......XXXXX......X...X...X......X..XXX....X....XXXX..XXXX..X....X.X.X....XXX...XX.X.
...XX...X..X....XX..X....X...XX..X...X.....X..XX.XX...XX..XX.....XXX...XX.....XX.....XXX....X.
XX....X.X....X..XX....XXXXX.....X........X.XX..X...XXXXXX....XXX.XXX.......X..XX..XX.....X....
XX..X...X.X...XXX..XXXXX.....X....XXX....X.....XXX.......XX..XXX.XXX..XXX..X...X....X....X...X
XX.....XX...X.....X......X.X.XXX...XX..XXX..X...XX.......X..XXXX....XXXXX....X...XX.X.XX...X..
XX...XXXX..X...XXX.....XXX...XXXXX.....XXXX...X..........X....X........XX.....X.......XXXX.XX.
XXX..XX....X.X.....X.X...XXXXXXXXX...X........X...X.X......XX...XX.X..........X.XX.X...XXX....
.....X.........XX....X.............X.......X....X...X.X...X..XXX...X..X.XXXXX...XX.X.X......XX
...X...X....XX..XXX.XX....X...X.......XXXX...X.....XX...X.X....X.XXXX.X...X....XXX.X...XXXX...
....X....XXXXXX...X.XX..X...X.......X..XXX.....X.XX...X.....XX.X..XX....X....X...X............
..X...X.............XXX........X.......X....X....XX.X....X........X..X.....X.....XX.....XXXXXX
XXXXX.X......X.......XX.XX...XXX.X..........X.X.X...X..X...XX...X...X..X.....XX....XX.....XXXX
........XX.....XXXXX....X....XXX.X..XXX.....X.....X...........X....XX.....X..X..X..XXXXXX.XX..
....XX.........X...XXX..X....X......X.....XX.....X......X........X......X.X....XX.XXXX..X.....
X...XXXX..X....X.X...X.....X...XX.....XXXXX..XX....X...........X.XXX..X.....XXX.....XX....X...
X..XXXXX....X......X...XXX....XX...X...X..X.....X..X...X.......X......X.XX.X.........X.XX...X.
XX....X..XX...XXX........X..X....X.....X..XXXX..X..X........X..X...XX...X..X.XXX...X.X.XX...X.
XX..X.X.XXX.....X........X..X..XXX........X......XXX....X...XXX..X...X....XX.X...X...X.X..X...
XX..X.X.XXX..XX.X.....X..X..X....X.....XX........X...XXXX..XXX..XXX..........X.........X.X...X
XX..X...X..X....X...X..XXX....X....XXX.....X...XX..XXX..XX...X....X.X...XXX.........XXXX...X..
XX.............X..X..X...X......X........X.....XX.XXXX..XXX.....X......XXX..X........XXXX...X.
XX..XXXX..X..X.X.....X.......X....X.XXXX....X...X.X.........X.X....XXX...X......XXXX..X...X.X.
XXX..........X.....X.X..X........X..XXXXX.....X...X...X..XXX..X......X...X...XX...XXX....XX...
.....XXXX..X....XX.X..........X..X...........XXX...XX.X......XX....X.X.....X...........X...X..
.......XX.....X.....X....X....X....XX....X.......X......XXX...XX...X.X..X........X...........X
..X....XX.X.......X.X........XX.X.....XX.XXXXXX..XXX...XX...X......X.X....X.X....X..XXXXX.XX..
..XXX...X....X.XXX........X..X..X.X......XXXXX.......X.......XX....X...X..X....XXXX.......XXX.
...XX.X....X...X...X.XXXXXX.X..X..X....XXXXXX..XX....XXX...X....X........X...X..XXXX......X...
.X..X....XXX.........XXX..X...XX.XX.XX.....X..XXX..XXXX....X..X.XXX........X....X......XX.....
..X....X...X......X.......X....X.X..XX..X..X...XXX....X.X...XX..XX....X...X.......X.XX....XX..
X....X...X..XX..........X...XX.....XXX..X.XXXX....X.....X.X....XXX.X....X....XXX..X..X..X....X
...XX....XX....XXX...X..XX..XXX.XX..XXX.....X.....X..X.XX.XXX..X...X.X.....X....XXXX....XX...X
.XXXX.X..X....X..X.X...XX...X...X...X.........X....X.X........XX......XXXX....X.......X.....XX
..X......X....X....X.XX...X...XXX.X........XX....X.....X.X....X...X.X.X...X...XX...X....X.X...
X...XX.X.X...X..XX...X..XXX....XX....X...X.....X.........X.XXXX.X.X.....X.X.X....X...X....XXX.
....X..X...X...XX....X.X....XX.X...X.....X.X...XX.....X....X....X....X......X.X..........X....
....X.............X..X...X..XX...X.........XXX....X.....X..X...........X......XXX..........X..</walls>
			</board>