<?xml version='1.0' encoding='UTF-8'?>
<board>
				<level>65</level>
				<width>26</width>
				<height>24</height>
				<walls>...XX....X..............XX
.X....XX.....X..X.....X..X
.X...XXXX....X....X......X
...X...XXXX....X.......XXX
....XX......X......X...X..
.XX..X..X...X.X.X......X..
.X...XX...X...X...X.......
.X....X.XXXX..XX....X...X.
...XX......XXXXX......X...
.......XX..XXXXX...X...X..
..X.......XXXX...X...X....
X.....XX.....X.X.......XX.
X..XX....X...X...XX.....X.
...XX..X............X.X.X.
.X.....X..X...X...X...X...
..XX...XX...X...X....XX..X
X....X.......X.....XXXXXXX
...X...X...X.....XXX..XXXX
.X.X.....X..XX.....X..XX.X
.X....XX.XX......X....X..X
....X....XXXX.......X...XX
..XXX...XXX..XX.X......XXX
...XX.....X...X....X.X....
...XX..XX...X....X...X..X.</walls>
			</board>