<?xml version='1.0' encoding='UTF-8'?>
<board>
				<level>177</level>
				<width>62</width>
				<height>62</height>
				<walls>..X....X.....XXX......XXXX............XXX...X...X...X..X......
..X.XX...X...X...XX......X......XX........X.X.....X.X....XX...
....XX..XX..XX.XX......X.X....X....X........X..X......XX......
.....X....X..X....XX.X.....X.........X...X..X......XXX...X....
XXXX....X.XX.XXX..XX...XX.XX.X.........X.XXXX...X..........X..
..X...X.X..X.XXX....X.....XX......X.XXXX...XX.........X.......
....XXX....X.....X......XXXX..XXX.X..XXXX..X.....XX.....X...X.
.XX...X..XXXX......X.XXXXX.....XX....XX...X..X....X.......X...
....X.XX......X..XXX.......XXX.XX...........XX.XX........XX...
XX..X........XX........XX....X..X..XXXXX.....X...XXX...XX.....
...X...XX.XX.XX...X....X........XX...X.......XXX....XX..X.XX..
.X...X.XX..X....X.....XX....XX...XX....XXXXX......X.XXX...X...
.X.........XXXXXX..XX..XXXX....X.XX.X...XXXX....X........XX.X.
.X....XXXXX.....X....X.........X........XX..XX.....XXX......X.
.X......XXX.XXX...XX.X..XX.......X...X......X..X....XX..X.....
.....XX.X...XXXXXX...X........X..X........X...X...X..XX.....XX
X.X.....X............X....X...X.....X...X.XX....X....XX..XX...
X...X......XX.....X..XX..X....X...X...X...X......X.......XXX..
XXXX.......XX...X.X......X.X....X....X..XX..X.XX...XXX...X...X
XXX..XXXX.....XX..X.XXXX.....X.X...XXX.XXX......X......XXX....
..X...X...X......XX....XX......X.X..XX.......X......XXXXX...X.
...XX.......XX..XXXX...XXXX......XX...XX.......XX.........X...
.X.......X..XX........XXX....XX..X....XX....X.........XX......
.X..X..........XX...X...X.XX....XX.....X..X......X.........X..
..X...XXX..X......XXXXX.X...XXX.XX...X..X....XXXXX...X.......X
X.X..XXXX..X.XX..XXX......X..XX....X..X...XX..X...XX...XXXX..X
X..X...XX.....X........X.....XXX..XXX...XX..X...X...XX...XXXXX
XX.XX.....X.X...X........XX.......X.....XX......XXX...........
...XX.X......X.....X..X.........X........X.X......XXX...X.....
....X......X.X.X.X..X...XX...X.........X...X.X........X.......
XXX....XXXXX.....X..X..XXX...X.X.......XX......X.X.......X....
....XX..XXXXXXX.....XX.....X.......X...XX.X......X...X...X.X..
.XX.....X.....XXXXX...X....X..X....X......X...XXXX....XX......
..XXXXX...XXX....XXXX....X....X..XX...XX....X...XX..X.....X.X.
X...X.....XX...X...X...X....X..X.XX......XX...X.XXX....X..X...
..X...XX..XX.X.....X....XX..XX.....XXX....X.....X......X.X....
......XXXX....XX....XXX....X....X.....XXX....X....XX.......XX.
...X..XXXX..X....XX.XX.....X.XX...X.X..XXX...X.X..XX....X...X.
.....X...........XX..X.XXX.X..X...X..X.....X.....XXXXX....X...
XXXX.....XX......X...X.XXX.XX.....XX....XX...........X.X.....X
.........X....XXX..X...X.....XXX......X..X.XX..........X.X.X.X
..X........XX...X.........XX.X...X.X................X......X.X
X...X.....XX........XXXXX......X.X...X....X.......X.....X..X.X
XX..XXX...XX.X.......XX................X....XXX......XX....X..
XX.XXX..XX.......XXX....XXXX.XX...X......XX.X......XXXX.XX.XX.
.....X.XX.....XX...XXX...XXX....XX..X.X.......XXX.......XX....
.XX....XX.X.XXXXXX...X.X.XXX..XX...XX...XX...XX......XXXX....X
....XXX.....XX.........X.X..X......XXX.....XXX...XXX.X....X..X
..XXX....X.....XX...........X...X..X.....X.....X.......XX...XX
..X....X..X...XXXXX.....XXX..XX.X..X.....X............X....XXX
....XX..X...X.XXXX..XXXX.....X.........X..X...XX....X....X....
...X....X..XX.XXXX....XX.......X..........X.X..X.XX.X.XX..X...
X....X...XX.....XXXXX...XXXXX..XXXX...X.XX..XX....X.....X...XX
..X.X..X..........X.....XX...X..X...X.X....X....X....X..XX....
.XX...X..X.....X....XXXX...X....X.X.....X....XX....X...X...X..
......X..XXX...X.X.XXX....XXX...X.X.........XX..XX.....X.X...X
......X......X.....X....X..XXXX..........X...X.XX......X....XX
.XXXXX..XX...........XX.XX.XXX...X.....XXX.X...XX.........X.XX
...XX..XXX.X..X..XX..XX..X...X.XXXXX....XX......X...X...XXX...
...XX.XX...X...XXXX..XXX.....X....X...X.....XXX...X...X...XX..
....X.....X..X.XX...XXX...X....XX.X.X.......XXXX..........X..X
..X.....X...XX....X.....X...XX....X..............XXX........XX</walls>
			</board>