<?xml version='1.0' encoding='UTF-8'?>
<board>
				<level>184</level>
				<width>65</width>
				<height>64</height>
				<walls>XXX..X..........XXX..X....XX.....X....XXX..XX...XX......XX.....XX
.....X.....XXXX...X..X.XX..X...X....X.X....XX.X......XX........XX
.X...XX....XX...X....X.XXX.XX.....X.X...XX........X..X....XX...XX
.XXX......XXX.X....X.X...X....X......X..X....XX...X.XX.X.....X...
.....X.X....X.X..X.X...............X....X.......X......X..XXXXXX.
X......X.X..X.X.......X........XXXX...X...XXXX.....X....X..X...X.
X..XX....X....X...X...X.....XX......X.X...XX.....X......XX.......
XX......X..XXXXX.....XX.X.....XXXX....X......XX.....X...XXX...X.X
..XXX.....X......X.X....X..X.......X.....X....X...X...X.XXX.....X
....X..X.....X..XX..X...XX...X.........XX..XX..XXX....X........XX
.XX.XX..XX.X.X....X...X.XXXXX.......XX....X....XXX.X..X...XX....X
....XXX....X...X......X.X.....X........X..X.XX.....XXX..X.....X..
...XXX....XXX....X......X....XX........X....X.....XXXX...XX......
.X...X.XX.XXX.X..XXXXX.XXXXX.XXXX.XXXX.....XX.X.X........XX.XX.XX
.X.....XX...X.XXXXXXXX.XXX...XXX..XXXX.....XX...XXXX........XX...
.X....XXXXX.X.XX.....X.....XX....XXXXX.....XX....XXX.....X.....X.
.X..XXXX....X....X........XXX.X...X..XX.....X....XXXX....X...X...
....XX...X..XX.....XX.XXX.....X.X....X..XXX.XX..X.....X....X....X
X.XX.....XXXXX....XXX...XX....X...XX...XXX..X...X.......X.....X..
X.XX..X....XXX....XX....XX.XX.....X......X....X.XX......X........
..XXX.X....XXX...XX..XXX............XX...XXX..X....X.........X...
......XXX....X...XX.XXXX..X......XX........X.......X...X.........
XX...XXX..X..X......XXXXX.X....X....X...X......XXX...X...XX...XXX
...X.X...X..XX..XXXXX.....X.XX...X..X.XXX.X.X.........X.....X....
.XXX.X.XXX.XX..XXXXXX....XX.XX......X.X...X...XXX...X.X...X......
.X.....X....X........X......X.....X...X.XXXXXXXX..X.....X....XXXX
.X..X.....X...XX.....X..X.....X................X.....X..X.XX....X
....X.XXX....X....XXXXX....X.......XXX...XX........X....X.X...X..
XXX........X....X.X......X...X.......X.XX...X.XXXX.XX...X...X....
XXXX.XX..XXX.XX.....XX...XX......XX....X..XXX.........X....XX..XX
...X.....X.....X............X.X..X..X....XXXXXX...X.X.XXXX..X..XX
.....XXX....XX.XXXXX..X....XX...X..XX.X..X..X...X...X.XX....XXX..
..X......XX..X...XXX..X..X.....XX.XXX.XXXX....X........X.XXX.....
....X........XX....X....XXXX...X..X...XX...XX...XXXX.X.X.......X.
...X....X.XXXXX.X....X.........X......XX........XX...X......X....
.....X....X..XX.X...XX.X....X....X....X...XX.......X....X.....X.X
XXX..X.......XX...X....X..X...X....X......X....X......X...XX..X.X
..X..........XX..X..X..XX.......X..X.X...XX.........X....XXX..X..
....X......XX..X...XX.....XX.XX...XX............X....X.X...X.....
...XX..XXX.....X......X..XXX..X..XX...X...X........X...X.......XX
.XXXXX..X....X....X....X....X..X......X.........XX....X.....XXX..
...X..X...XX....X....X....X....XX....X.....X.......XX...X....X...
XX....X.....X...X..X....X.......XXX....XXX.....X.X...X.....X...X.
X...X.....X.X.XXX..XX...X..XXXX.....XX......XX...XX....X......X..
X.X....XX.X....XX.....X.X....X....XXXX....X.XXX...X.X....XX.X....
X....XXXX..X.X.XX...X.X...XX...XX...XX..X.X.....X.X...X..XX....X.
...XXXXXXX...X....XXX.X..XXX..X.....XXX...XXXX..X............X...
....X....XXXXX..X.....X...XX....XX...XX......X...X.....XXX.......
XXX....X...X........XXX........XXX.X.X.........X..XX.....X....X..
..XX.X...X....XXXX.....XXX.X.......X...X....X...X.....XX....X...X
..XX.....XX.X...X..X...X...X..........XX......X..X......X...X...X
............XX....X......X....XX....X......XX....X.X......X......
...X....XX.....X....X...X...X.......X..XXXX....X.......XX......X.
.X...XX.......XXXX...XX...X.....X...X..X.....X...XX....XX..X.....
.....X....X...XXXX.X...XXX...XX...X......X...X......XX..XX....X..
X....X......XXX..X..X..X...X..XX..XXXXX..X...X....X...X..X..X....
..X.....XX..........X.X..X....XX.XXXXXXXXXXX....X.....XX....XX...
....X.X....X......XXX...XX.XX..X..XXXX...X......X.XX.....XX.X....
.X....XX..........X..XX..X.....XX......X.X.XXX.......X...XX.X.X..
.X.X...X..XXX...XXX..XX..XXX...XXXX....X.X.X...X.XXX.....X..X...X
.X.....XX.....X......X...XXX.X.XXX..XX...X.....X...X.XX..X...XX..
....X...XXXX.......X...X.X...X.....XXXX........XXX...XX..XXX..XX.
X.XXX.X.X....X.XXX.....X.....XXXX..XXXX...X....X.....X...X....XX.
X.....X...X..X.........XXXX..XXXX..XXXX.....X..X.....X...X.......</walls>
			</board>