<?xml version='1.0' encoding='UTF-8'?>
<board>
				<level>122</level>
				<width>45</width>
				<height>43</height>
				<walls>...XXX....X...X....X....X..........XXXXXXXX..
.X.....XX.X.X...XX.X.XX....XXXX....XXXX...X..
.XXXX..XX.......XX.......X..X...X..XX...X....
.XXX..X....X....X.....X...X...XX...X.........
........X....X..X.XXXX..X..XX....X.X.X...XXXX
X....XX...X.......X....XXX....X..X.......XX..
..XX..X...X...XXX...X.........X..XX...X...X..
.XXXX.........X...............X....XX.X.X....
......XX...XXXX......X...XXX..X.....X...XX...
..XXX..XXX...........X.......XX...X.....X....
...XXX........XX.....X..X....X....XXX...X....
.X...X..XXX...X......XXXX..XXX.....XX.XX...X.
.....X..X...XX..X....XXXXX....XXXX....X..X...
X....XX.....X..X..XX.X...XX........XXXX.....X
..XX..X.XX..X....XXX...X.......X.......XX....
.XXXX...XX..........X..XXX...X....X..X...XXX.
...X...XX....XXXXX..X..XXX...X.XX....X.....X.
.....X.X..XXXXXXXX.X...X...X.....X...X..X..X.
....X..X....XX.......X...X....X.........X.XX.
..XX..XXXXX.......X.....X.......X.X...X......
XX...X...X....XX......X...XXXX....X......XXXX
XX.....X.X.......X.............X...........XX
....X...........X.................XX.......XX
..X.....X.....X.X.X..........XX.X....XX......
X....X..X..XX.....X...XX...X..X.X.........XX.
...XX..XX..X...X...X..X....XX...X.XXXX.XX.X..
.X....XXX....X...X...X..XX.....XX....X.X....X
.....XX...XXXX.......X.....X....X..X.X...X...
........XX........XX......XXXXX.X........XXX.
....X.........X....XXX....X..XX...X...XX..X..
..X.......X.....XX..X..X..X....X..X....XX.X.X
XXX..X....X.XX....X...XX..X.X.....XXXX......X
XXXX...XX......XX.X..XX..XX.X.X.X......X...XX
XXXX...X..XX....X.X...X...X.....X..XX....XXXX
XX.....X....XXX.X...X...X.XX...X...XX.X.....X
...XX....X......X....X.......X...X......XXX.X
..XX..X....X.......X...X...XXX.XX....X......X
X.X..XX.X........X....X..X........XX...X.X...
..X.....X...XXXXXX..X.X...............X..X.X.
..X.......X...XX..XXX.....X......XX.X...X..X.
..X..XXXX..XX.....X.........X.XX....X.....XX.
XXXX....X....XXXX......XXX..X..........X.....
XXXX..X...XX.........X...............X.....XX</walls>
			</board>