<?xml version='1.0' encoding='UTF-8'?>
<board>
				<level>73</level>
				<width>28</width>
				<height>27</height>
				<walls>XXXXXX...........XXX..X.....
XXXXXX.......XXX.XXX....XXX.
XXXXXXXXXX...XX..XX..X...XX.
XXXX.......XXXX...X.XX.X....
.....XX...X.....X.X....X...X
.XX...X.X...X.....X..XXX.X.X
.X..X.X..X.....X...X.......X
.X.......X...X...X.....XX...
...X...XXXXX...X.XX..X......
X....XX..........X..X...XXXX
X.X.........X.......X.X....X
X...XX.X........X...X.XXXX.X
....XX...X...XX.....X.X..X.X
.X....X....X........X.X....X
.X.X....X....X....X...X.....
...X.X....X....XX..X......X.
X......XX...X....X.XXX.XX...
..X.....X.....XX.X..X..XX..X
.X..XXX........X..X...XXXX..
.X....XX.....X....X....X....
...XX......X....X....X......
X..XX.........X....X...XX...
...XX.XXXXX...X.XX..X..X....
.X..........X....XX...X..XXX
.X..XX.X.......X...X..X....X
.X...X....XX........XX...X..
...X....X.........X....X....</walls>
			</board>