<?xml version='1.0' encoding='UTF-8'?>
<board>
				<level>142</level>
				<width>51</width>
				<height>50</height>
				<walls>...X......X.......XXXX....X..X.........XX..........
.X....XXX.........XX....X....X......XX.XX...X....X.
.XX.X....X.X......X...X..X...XXXXX.....XX...X.X..X.
.XX.XX.....X.XXXX...X.XX...X...X...X....X.....X.XX.
..X....XX.XX..XXXX..X..XX..XXX..........X..X.......
X...X.....XXX........X..X.XXX.....X.....X..X.X...XX
X.....X....XXX.......XX...XXX.XXX...X...XX.....X..X
X........X.XXX.X....X.........XXX..XXXX.....X.....X
X......X.X.......XX...XXX........X...XXXX...X.X....
.....XXX.....XX........XX........XXX......X...XXXX.
.X....XXXXXX.......XXX.XX..XXX...X..X.....XX...XXX.
.XXXX.........XXXX...X..X..XX..X....X.XX...X.X.....
.XX..XXX...XX....XX..XX.XXX...X...X...X..X...XX..XX
......X..X.X.....X..XXX...X..XX.X....X..XXX...X..XX
X...X.X......XXXXX.XXX....XX....XXX....XX...X....XX
..X.......XX..XXXX.....X......X.....X..........X...
.XXX...XXX....XXXX..X....XX...X.XX....XX...X...XXX.
...X.XX....XX.XXXX..X...X...XXX.X..........X.XXXX..
XX.X......XXX..XXXX..X..X.XXX...X......XX....X....X
.....X.XX.XX...X.....X.X..X.......XX......X..X.....
.XX....X..X..X.....X...X............X...XX......XX.
......XX.XX...........XXXXXX.....X....X.XX.XXXX....
X...XX...XXXX.....X...XXXXX....X...X.............XX
..X....XXXXX....X...XXXXXXX..........X.X.......X..X
.XXXX..XX....XX.....X.........X...XX...X.X.XX.....X
....X..XX.......XX....X.....X...X..XX....X..X.X....
XX...........X...X.XX...XXX........XX.X...X......X.
XX.X....X......X.X.XX.....XX.....XX.....X....X.....
...XXXX....XX......X.......X.....XX..X.....XXX.XX.X
.XXXX....X......X....X...X.....XXXXX...XXX...X..X..
......X...X.....XXX..X.XX...XX..X.........XX..X....
..XXXXX.X.....XXXX...X.X..X.....X.X.....X.X...X..XX
XXXXXXX...XX....XX...X...X....X...X.....X...X.....X
.......XX....X.....XX......X..XX....X....X........X
.XXXX..XX..X...X.X.XX.....XX.XXX.........X.XXX.X...
......XXXXXX...X........X.....X....XXX.....XX..X.X.
....XX............X.........X...X....X..X..X..X..X.
.XX.........X...X....XXX...........X.XX.XXXX....XX.
..X..X..X.....X....X.......X...X.X.X..X.XXX....X...
X.X...X....X.XX..X....XXX....X...X.XX...XX..X....XX
..X...X..X.X..XX.XX.X.....X...XX...X....X..XX.X....
.XXXX....X.XX..X.X..X..X......X....X....X...X......
..X...XX...XXX.X.X...X.XXX......X..XXXXX....X..XXXX
X.....X....XXX....XX...XXXXXXX....XX..X..XXXX..XX..
XX....X....X....X...X..XXXX..X....XX....XXXXX..X...
..XX......XX.XXX.......XXXX....X...X.....XXXX....X.
..XX......X..X...X.......XX......X...XXX..X...X..X.
.........XX......XXXXXX...X...XXXX.....XX...XXX..X.
...X...X.........XXXXX..X...XX..XX..XX..XX......X..
.....X...........XXXXX..........XX..XXX......XX...X</walls>
			</board>