<?xml version='1.0' encoding='UTF-8'?>
<board>
				<level>163</level>
				<width>58</width>
				<height>57</height>
				<walls>..........X...XXXXX..XXXX..XXXXX.........X..X.............
..X.....X...X.XXX....XX....XX.........XX....X.X.......XXX.
X...XX........X....X.X.....XX.X...X.....X...X...XX........
XXX....X.........X...X.X...X....X.........X.XXXX...XXX.XXX
....X..X..X...XX....X......X.X.X..XX...XX...X.....XXX..XXX
...XX..X....X.XXXXX...X.XXXX.X...XXX.XX....XX.X.X...X.XX..
......X..XXXX......X..X...XX.....X...X..XX....X.XX..X.....
..X...X.....XX.......X....X...XX.X.X...XX..X..X....X......
..X.......X.......X....XX...X.X..X.....XX....X....X..XXXXX
X....X.....XX.XX..X.........X.X.X......X..XX...XX.X...X...
..XX...X.X....XX.X.......X..X.....X....X.XXX....X...X...X.
.XXXX..X....X......XXXX......X...XX.X..X.....XX.XX....XXX.
....XXXX..X.....X.....X.X.X....X....X.....X...X....X...X..
..X..XXX.....X..X...X.....X.X.........X.X...X..XX....X...X
..XX.....X..XX.XX.X..XXX......X.....X...XX...X.XX.X...XX..
...XXXXXXX..XX..X..X.....X.XXXX.XXX........X......X.X.XX..
...X........XXX....XXXXX.X..XXX...XXXXXXX..XX...XXX.X.....
XXXX......X.XXX..X....X.....X...X...X.....XXXXX..XX.XXX...
XXXXXXX.....XXXX....X...X.....XXXX....XX.....XXX....XX..X.
....XXX..X...X....X.XX..XXXXXXX....X...X.X.X.......XXX....
.XX.XXXX...X......X....XXXX..........X.....X..X......X...X
.XX..X..XX.XXXX...XXXX.XX...XX.X........X.....X...X....X..
...X....XX......X....X......XX........X...X...X.....X.....
.....XX.XX...XX.X..X....XX.....XX...X....XXXX....X........
.....XX....X..X....XXXX.X....X....XX...X..XX...XX..X.X....
........X..XX....X......X.XX..X..XX..X.XX.XX.X....X..X....
....XXX.X..X...XX.......X.....X..XX.XX.....X...X..X.X.....
.....XX...X..X....XXXXX.....X....X....XX.X.....X..X...X...
.....XXX....XX..XXXXXXXX....XXXX...X.....X..X......X....X.
XX.......X...XXX..XXX....X......X....XXXXX..X.X.X..XXX....
........X....XX...X....XXX.X......X....XXXX.....X.XXX..XXX
..X.XXX.X.......X....X..X..X.X.......X....X..X......X....X
X.X......XXXXX....XX..X.X....X...XX..XXXX....X...X....XX.X
....XX.X...XXX....XXX...XXX..XXX....XXX...XX.......X..X..X
.X.....XX....X........XXXX..........X...X.X.....X....XX...
...X....X.X......XXXX.XX...XXX........X.....XXXXX......XX.
..XX..X.X.X.X...XX.......XX..X..XX.......X.....XXX........
XXXXX.X.....X.X......X.......XX...XXXX.X.......XX.......XX
.........X........X........X...........X..........X...XX..
...X...X...X...XX...XXXXXX.......X............XX......X...
XX.X.X.......X.......XX.................X........X.XX...X.
.....X..X........XXX.X....XXXXXXX.XX....X.XX.XX....X..XX..
.XX...X.......X....X...X..XXXX....XX.XX.X.X..XX.X....X...X
....X.XX..X.....X......X.....X.......XX...X.........XX....
..X.X.XX..X....XX...XX...X.......XX...........XX.X..XXXXX.
..X...XX..X..X....X.....XX.XX.XX.X..X......XX....X.XXX....
XX...XX...XXXX..XXX.XXX.XX.XX....X.......X.....X.....X.XXX
...X....X.......XXX.....XX.XX...XX...XX....X......X..X....
.XXXXXXXX.....X....XXXXX......X....XX...X...XXX...X.XXXXX.
...XXXX...XXX.XXXX...X...XX.XXX..XX.......X.XXXXX.....X...
X..X..X..........XXX....XX..XX....X..X...XX...XX...XX...XX
..XX....XXXX.X...XX...X..X...X....XX...X..XXX....X.......X
.X...XX..XX..X.XX...XXXX...X..X...XXXX.XX..XX..X...X..XX.X
...XXXXX....XX.X..XXXXXX....X...X..XX..XXX..X......XXXX..X
.....X.........X...X......X..X..XX....XX..X...X.......X...
...X......XXX...XX.....XX..X....XXXX...X.....X....XXX..XX.
XX......X.....X.....XX.....X..X......X...XXX...XXXXXXX....</walls>
			</board>