<?xml version='1.0' encoding='UTF-8'?>
<board>
				<level>59</level>
				<width>24</width>
				<height>22</height>
				<walls>....XX..XXX.......XXXX..
.XX.XX..XXX.....X.XXXX..
.XX.....X..XX.....X.....
.XXX..X....X..XX.....XX.
..XX.....X...XX....X.X..
X....X......X...X......X
XXXXXX.XX.X...XXX...X.XX
..........XX...XXX....XX
......X...X..X.X...X....
..X...X.X...XX.X.XXXXXX.
X...X...XX..XX.X........
......XXX......XX......X
.X........X.....X....X..
.XXX........XXX..XXX....
.XXXXX..XX.......XXX..XX
.XXXXX..XX...XXX......XX
.....X...XXX.....XXXX..X
.....X.X......X....X...X
....X..XXX......X.....XX
..X.X.......XX....X.X..X
..X.....X.X......XX..X..
..X..XX...X..XXX.....X..</walls>
			</board>