<?xml version='1.0' encoding='UTF-8'?>
<board>
				<level>139</level>
				<width>50</width>
				<height>49</height>
				<walls>...X..XXX..XXXXX......X...XXXXX.......X..XXX......
.X.X....X.....X..X....X.X...XX..X.....X..XXX.XXXX.
.X...XX.X.X.....XX...X..X....X......XXX....X......
.X........X..X....XX...XX..X.....X..XXX.X..X.....X
.....X.X...X..XXX.......X..XX......XX...X.X..XXX.X
X.X....X.X.XX....XX...X.X..XX.XXX..X..X.....XX...X
X...X....X..XXXX....X...X..XX.....XX.........X..XX
......X..XX...XX..XXX..X....XX........XX.....XX..X
.........X..X.....XXX....XX..X..XX.XX....XXXX..X..
.....X...X......XXXX..X....X..X.XX..X..XXX.....XX.
.X...X..XX...XXXX....XX....XX.......XX.......X..X.
...XXX.....X......X...X........X....XX.XX.XX.XX...
..XXXX...X........X.X.X...X.......X....X..XX...X..
...X...XXX..X.....X.......X..XX.X.....XX..........
.X.X........X.XX....XX.XXXXX..X....XX...XXX.....X.
.X.....XXXX...X..X..XX...XXXX....X.XX...XXXXX.....
.XX....X...X..X....XXXXX.......X.X..X......XXX...X
.X....XX.X.X....X..XXXX..XXX.X...XX.X..XXX.....X..
...X...X.X...X.....XXXX..XXX........XXXXX...XX..X.
X....X...X.....XXX....X.....X.....XX......X.......
..X.....XX..........X...XXX.XXX.X......X.....XX..X
....X.X..X......X......X....XXX.....X....X.X.XX..X
XX....X..X..XXX.XXXX...X..XXXX..XX....XX...X..X...
...X.....X...XX....X....X...XX.....XXXXXX...X.X.X.
......XX...X...X........X...XX...XXXXX....X.X...X.
..X.X...X..XXX...XX............XXXX....X..X..X....
..X..X........X.....XXXX...XXX......X....X...X.X..
.....X.X........X...XXX..X...X.....XX......XX..X..
...XXX....X..X.....XXXX....X....XX.XXXX.......X..X
.....XX...X......X...XX...X...X.........XXXX..X...
XXXX.X..XXX...XXX.......X.X.X.....XXX.....X.....X.
XXX..X.XXXX.XX....X.........X..X...X........XXXX..
XX..XX......X..X..X......XXXXXX..X...X...XXX.....X
XX............XX....X...........X......X..XX.XX..X
...............X......XXX....X....XX....X..X......
.X........X..X.....X......XX.XXX......X.XX..X...X.
.X......X....X..XX...X.......XXXXXX.....XXX...X.X.
.X...XX....X.....XXX....XX..XX..XX..XX...XXXXXX...
...X.XXXXX..X..X.....XX.XX...X...X..XX.X......XX..
..XX.....XX...XXXX...X.....X...X.X.....XXX......XX
XXXXX....X....X......X.X....XX.....XXX.......X....
......X..X........X....X..X.........XX....X....XX.
...XXXXXXX.....X....X.....XX..X..XX.....X...X.....
......XX...X...X........X.....X..X..X......XX.XX..
....X.XX......XX...XX...X...XXXXXX.....X...XX.X...
....X.....X.X..X.......XX.X....XXX...X...X....X...
.....X......XX....XX.X....X..X...X...X..X..X..XXXX
.XXX....XX...X..X..X.........XXX.X....X....X..XXXX
......X......XXXXX.........XXXXX......X....X..XXXX</walls>
			</board>