<?xml version='1.0' encoding='UTF-8'?>
<board>
				<level>67</level>
				<width>26</width>
				<height>25</height>
				<walls>..X.....X............X....
..X.X.....XXX..X...X...X..
....X..X.X.....X.X..XX...X
.....X.X....XX......XX....
XXXX......X.....X.......X.
..XXX.XXXXX..X..X...XXX...
....X...XXXX...X..X......X
.....XX.X.....X..XXX......
...X..X...X.....X....XX.X.
.X..X.....X....XX.XXXXX...
....XX.........XX.....XX..
XXX......X.X....XXX.......
XX..X.XX.X...XX.X....X....
XX....XX.XX..X..X..X....XX
XX...........X.....X....XX
XX....X...XX.....X.....XXX
...X..XXX..X..XX..........
.....XX....X......XX..XXX.
XXX...X.........XXXXXXXX..
X...X.......X....X.......X
X.XXX..X......XX.....XX...
..X....X.XXX...XX.X.....X.
.X...X...X...X....X.X.....
.X.X.....X.XX...XX........
...XXXX..X....X....X......</walls>
			</board>