<?xml version='1.0' encoding='UTF-8'?>
<board>
				<level>123</level>
				<width>44</width>
				<height>44</height>
				<walls>.....XXX....XX...XX..XX..X....X......X.....X
...X...........X.....X...X.XX.X....X....XX.X
XX......X........XXX...X...XX..XX.....X.XX.X
XXX.....X.X...........X...X....XX.X........X
....X...X.XXX...X..XX.X.X.X.XX......XX...X..
...XXXX.....X.X.X.......X.X......X....XX....
........XX....X..XXX...XX.....X....XX...X...
....X......XXXXX.XXX...XX..X....X.X.........
..XXX.XX.....X.....X....XXX..X..X...........
...XX......X........XXX.X...XX..XX..........
...XXXXX...XX.....X.....X...XXXXX....XXXXXXX
XXXXX....XXX..X......X......XXX...XXX...X...
X.......XXXX.......XXX..XX..XXX.XXX...X.X.X.
..XXXX.....X........XXX.XX..XXX.XX....X.....
.XXX...XX..X.....XX........XXXX....X..XXXX.X
...X.XX...XX.XX..........X...X.........X...X
...X.........X..X.X......X.....XXXXX.....X..
.........XX....X..X....X....XXX.............
....XXX.....X..X.XXXX.....X........XX..XXXX.
..XX.........XXX.XXX..X.XXX.XX...X....XXX...
...X...XX..X..XX.....XX.XXX....X.X..X...X.XX
...XX..X...XX.X......XX.X....X...X..XX..X.XX
XX.....X.X......XXXX..X....X......X..X.XX..X
XX..XX.......X...XXXX...XX...XXXX....X.X...X
XXX.....X........X......XXX..........X...X..
X....X..X..XX........X...XX.X....X..........
...X...XX.....XXX.X....X..X...XX....X..XX...
.X.....XX...X...X...X...X....XX...X..XXXXXX.
....X..X..XXXX..........X..X..X.XXXX.....XX.
..X...X..XXX...X.....X...XXXX.X.XX....XX....
XXX.....XX.......XXX...X.X....X.....X.....XX
XX..........X....X...XXX.....X....X.X...X.XX
...X......X..XX....X...XX......X....X.X...XX
.XXX.......X.XX.XX.....X....XXXX.X....XX...X
.XX...XXXX......X..XX....X....XX.XXX.....X..
.XX...XXX...XX....XXX......XX..X.......XX...
..X..XXXX......XXX.....XX..X...XXX.....X..XX
X.X.....X.....XXX..XX........X..XX..X..X.XXX
..X.X.....XX......X...X.........XXX..XXX.X..
.X..X.XX.....X........XXXXXXXXX....X.....X..
.X.....X...XX....X.......XXXX......X........
.....X...X..X.X......X......X........XXXX...
..XXXX....X...X.X.XXXX.XX.X......XX..XX...X.
..XXXX....X..XX...XXXX....X..XXX........X...</walls>
			</board>