<?xml version='1.0' encoding='UTF-8'?>
<board>
				<level>103</level>
				<width>38</width>
				<height>37</height>
				<walls>.......X......XXXXXXXXX...XXXXX...X...
....XX.....XX..XXXXXXX..X.XXXX..X.....
........XX.X...XXXX....X..X....X...X..
...X.........XX.......XX....X..X......
...XX.....X...X..........X..X..XXXX...
......X.......XX.....X.........XXX....
..X.....XX.XXXX..X.....XX.X....XX..XXX
.....X.....XXXX.XX..X...X.....XXX...XX
...X...X..............X.XX....X...X...
XXXXXX....X....X.........XXX..........
....XX..X...XX.....XXX.X...X...X.X...X
.XX.X....X.........XX..X.....X..XX.X..
..X...XX.X.XX....XXX..XX..XXX...XX.XX.
X.XX.....X....X....X..........X.......
.....X..XXX.....XX..XXXXXXXX....X.XX..
.X.X....XX.......XX....X...X......XX..
.X...XX....X...X.XX......X.....X......
.XX..X.....X.X...X....X.XX.........XX.
.X.....XXX.X....X..X....X..XXXX.......
.X....XXX.....X...X..X....X...X...X...
....X.....X.XX......X..X....X...XX..X.
X.....X..XX....X...X..XX...XX....X.X..
......X...XXXXXX...X.X...XXXX..X.....X
.X......X........X.....XX..XXX....X...
...X.......X.......XX.XX...X....X..XX.
XX.XXXXX...X.XX.....X....X......XX..X.
XX..XX...XXX....X.X...X...........X...
XXX....XXXXXXXX.X.XXX...X.......X....X
.....X..XX...XX.X...X.........X....XXX
...X....XX.X..X.....X............XXX..
XX....X.....X.X..X.........XXX.X......
X.........X...X....X.X.......X......X.
..X..X.......XX......X...XX.....X...X.
.XX......X...XXXX....XX..XX.........X.
.XX...XX.XXX..XXX..X....X....XXXXX..X.
..X.......XXX....X...XXXX.XX..XXX.....
X.......X........XXX......XXX.....XXXX</walls>
			</board>