<?xml version='1.0' encoding='UTF-8'?>
<board>
				<level>55</level>
				<width>22</width>
				<height>21</height>
				<walls>..............X.......
.....XXX...XX.X.......
...X.....X..X.X......X
.X.....XXXX.....XX...X
.XX.........XX.XX.....
.XX...X.XXX....X..X.X.
..XXX...XXXX...X.X..X.
X..X...XXXXX.X...X....
...X.X.........XXXXXXX
.......X.........X....
...XX....X....X....XX.
.X.X..XX....X...X.XX..
.....X...XX.......X..X
X..........X.....XX...
........X....X........
..........X....XXX....
......XX..X.XX........
...X.....XX.XX....X...
.....X.X..X....X..X...
XXX....XX.X...X...X...
XXX.....X...X...X.....</walls>
			</board>