<?xml version='1.0' encoding='UTF-8'?>
<board>
				<level>167</level>
				<width>60</width>
				<height>58</height>
				<walls>XX..XXXX...X...X..X....XXX...X...XX..X...X...XXX....X..X....
....XX...X...X....X..X.X...X...X.....X.X...X.X....X....X....
.XX.........X.....XX.X......X..XXXXX...XX..X....X...XX.XX...
....XXX...X...XXX.........X.XXXXX......XX.......XX..X..X..X.
X...X...X....X....X...X...X............XX...X....X.XX....XX.
..XXX.....XX...X...XX...X..XXXXX......XXX...X.XX.X.XXXX..X..
.X.....X......XX.X....XXXX.X........X.XX..X.X.X..X.XXX..XX.X
...X...XXX.XX....XX........X...XX.XXX..X..X...X.........XX.X
X....XXXX..XXX.........X....XX....XXXX.X..........XX.......X
X...XX..X...XX.....X.X....X..XXX.....X.X...X...X.....X......
X....X....X...XX...X....X..X...X...X.....X...X.X.........XX.
X..X..........X......XX.XX.XXX.......XX......X.XX...X....X..
XX..X...........X.....X....XXXX...X.......X..X....X.....XX.X
X..X............XXX.X.......XXX...X.X.XXX........X...X..XX..
X....X..........XX..X..X....XX....X...X........X...XX..XX...
XXX..............X........XX...XXX...XX.XX.....X..XX..X...XX
XX..X.XXXXXXXX.....X....X..X.X...X.X.......X...X...X.XX.X...
......X..X.....XX....XXXXX.X...X....XX...XXX.X...X...XX.X.X.
.....X...X...XX...XX..XXXX.....XX.X....X.....X..XXX..X..X...
...XXX.X.X...XX.X.....XXXX.....XX.X..XXX....XX.......X...X..
....X..X......X.....X..XXX.....X..X...XXXXX.XX...X...XXX....
..X...X.....X....XX.XX.XXXXXXX...XX.X.XX.....X......XXX...X.
X....X..XXXXX..XX...X..X...X......X...X..X.X......X...X.X.X.
XXX....XXXXXX.......X....X......X....XX.XX.........X....X.X.
....X.X..XX......X....X.....X......X..X...X........X.X.XX...
..XXX....X...XX....X....X......X.X.XX.......XXXXXXXX.X..XXXX
X........X.X..X.X....X.......X...X.X...X.....XXXXXXX..X..X..
.........X.XX.....X..X...XXX....X....X.....X.XX..XXXX..X....
.XXXXXXX...XXX.X.....X.X......X...X.XX..X....X.......X......
.XXXX......XXX...X...X......X.....X.....X.X....X..XX....XXXX
..X...X....XX...........X...XXXX....X.......X..X..X...X.XX..
X...X.....X...X...XX........XXXXXX.......XX....X....X...X...
.......XX...X...X.......XX...XXX...XXXX..........XXX......X.
.X...X.....X....XXX.XX..X..X...X....XXX..X....X.X....XXXXX..
...X...X.....X..XXX.X..XX........XX.X..X...X....X..XX..X...X
XXXXXX.X..XXXX....X...XXXXX.......X....X.....XXXXX..X....X..
....XX...XXX...X.......XXX..X...X..XXX....X....XXXX...XX....
....XX...X...X...X.....XXX....X..X..X...X......X............
X...X......XXXX......XXXXX.X.....XX...X....X...X.X......X...
X.X...X......XX.X.XX....XX.X.X...X.......X.X.X.X...XXX......
X..X.......X.XX.X..X..X..X...X.....XXX.X.X...X....XX...X.XXX
XX..XX.X.....X.....X..XX.....X....XXXX.......XXXX........X..
XXX....X..X.XX.X......XX..XX.X.....XX...X....XXXXXX.....X...
........X...XX......X......X.....X.XX...........X...X...X.X.
....XXX....XXXX........XXX....X.....X..X.X...X....X...XX....
X...XXXX....XXX..XXX.X....X...X.X.X.X....X.X.X.X...X...X.X.X
....XXX..XX.XXXX.....XXX....X...X.X...XXX..X...XXX...X...X..
.X..XXX.....X.....XX.....X........X.......X...XXX......XX...
.X..XXX...X.....X............X...XX...X..X..X...X.XXXX.X..XX
...XXX..X....XX.....X.....XX.....XXX..X....XXXX.X...XX...X..
...XXX.XX.XX..........X.....X........X..XXXXX.......XX......
....XX.XX.....XXXXXX..XXXXX.....X...XX.........X.X......X...
..X..X...X..X......X..XXXXXX......X.XX....XX.X.X...XX.X.XXX.
XXXX.....X..X..XX.......XXXX...X..X....XX.XX.......X..X.X...
......XX....X.....X.....X....X....X..XXXX..XX...XX.X....X.XX
..X.......X......XX...XXX......XX.X...XXXX....X....XXX..X...
X..XXXX.X....X.X..X.X..X...XX..XX...X..XXX..X...X..XX....XX.
XX......X..X...XX...XX...X.............XXX..XXX.......XX....</walls>
			</board>