<?xml version='1.0' encoding='UTF-8'?>
<board>
				<level>162</level>
				<width>57</width>
				<height>57</height>
				<walls>.....XXXXXXXX..XX.......XX....X......XX.......XXX...X....
.X.........XX...X..........XX.X.X.......XXX...X...X...XX.
...XX.XXX.....X.X......X....X...X...X.XX........XXXXXX...
X.....XX..X.XXX...X....XXXX....XX.....XX.XXX.....XX......
..XXX....X..XXXXXX..X..XXXXX....X................X..X....
...XX.X....X..XXX..XXXXXXXX.....X.......X....XXXXX.X.....
XX....X.X.....X...XX....XX..XXXXX..X....X..X.X.....X.....
..XX..X.....X.X......XX..X...X...X...XX.XX.X......XXX..XX
......XX.XX.X....X....XX...X.....X..XXX....XX...X.XXX...X
...X.....X..XX...X.XX.........X..XX.....X..XX......XX.X..
.X...X.....X.....X...XX...X......XXX....X......X.X....XX.
.....X..X....XX.........X...XX...XX..X..XXX......X..X..X.
X....X...XX.X...X..........XX..X....XX....X...X...X....X.
X......X.XX.....X........X.XX....X.....X....X.XXX....X...
....X......XXX..X...XXX.....X.XX.X...X.X...XX.XXXX.X...XX
........X..XX.....X.....X.X...XX...X.....XXXX..X...X....X
XXXX.X..X.....XXX....X..X..X....X..XX.....XXXX...X....X..
..XX...X..XX.......X....XX....X...XX...XX....XX.....X..X.
....X....XX..XXX...XX...X...X.....XX.X.....X......X....X.
.X....X.X...X....XXXX.XXX....X.....X.X..XX.....X....XX.X.
...X....X..X..X...X...XX.....X.X.X.X....XXX....X.X...X...
X....XXXXX.X....X.....X..X.......X....X.....XX.X...X.XX..
X......X......XXXX......XX...XX.....XXX...XXXX.......XXXX
.....X......X....XXX.X....XX....X....XXXX....XXXXXX......
.XXX.XX.....X..X.....X..X.XX..X...XX.XXXXXXX......X.X....
.....X..X...X..X......X...X...X....X.X........XXX.X....XX
....XX....X.X.....XXX....XX.X....X.X........X..XX....X...
.X.....X..X...X.X.X....X.......X........XXX.XX.....XXXXX.
...X.....X....X.....X..X..XX.....XX.....X.....XX....X....
..XXXXX....XX....XXX..XX...X....XXX...X...XX...XXXX....XX
.....X..XXXXX..XX....XX..X.X.X..X...X....X...X.......X...
.......XXX...X....X.....XX...X.XX......X...XXX..X...XXX..
....X......X.....XX...XXXX...........X........XXX.X.X...X
.....XXXX..X..X....XX......XX.XXX........XXXX.XXX.X.....X
...X......XX....XX..........X..XX.....X....XX.XXX.XX....X
....XX....X..XX..XXX...........XXX....X.......X..........
XXX.X..X....XX.....X...X...X.X.....X....X...XXX.XX.XXXXX.
..X.X.X..X..........X....X.X......X.......X..XX..X...X...
..X...X...X...X...X.............X.X..........XXX...X.....
...X..X.X...X...X....X.XX...X..X..XXXX.......X........X..
.X.X....X..XXX.....XX..XX.XX...X.XXXXX.XX.........XXX....
.X...X...X...X.X......X...XX.X.......X....XXX...X......X.
..X....X...X...XXXXX....X....X..X.X....X......X......X...
X...X..X..XX..XXX....X....X..X....X.X....X.......X.......
XX....XX...X....X......X....XX...XX.X......X........XX...
XXXX.....X...XX....XX..X.XX.XX...XX.....X....X....X......
..XX........X....X....XX.......X..X.......XX...XX.....X..
...X......X......X..X.X......X....X....X...X..XXX..X....X
.X...XXXX...XX...XXXX...XXXXXX.XX....X.....XX..XX..X.X...
.X..X..........X...XXXXXXXXXXX....XX....XX.....XXX...X.X.
........XX...X.XXX....XXXXXXXXX...X...X....XXX..X......X.
X....X..XX.....XX..XX.XXXX........X.....X..X..X...X.XX...
..X....XX..XX...X.....X....XXX....X....X...X........X....
....X...X..XX.X...XX....X....X......XX.X.X.X...XXX....X..
XX....X.X.....X..XXX.X..X.X......X...X.X.X...XXXXX.X....X
X....X....XXXXX...X.....X...X.X....X...X....XXX......X..X
X......X........X...X...XX..X...X..XX..XX.......XXX....XX</walls>
			</board>