<?xml version='1.0' encoding='UTF-8'?>
<board>
				<level>54</level>
				<width>21</width>
				<height>21</height>
				<walls>X.....X..XXXXXX..X...
..XX..X....XXXX....X.
.XX..X..X....X..XX...
....XX....X....X.....
XX.....X....X....XX..
X..XX....XX.....XXXXX
..X...X.XX...X..XXXXX
.X....X....X.X.XXXXXX
...X......X..X.X..XXX
X....XXXX...XX.X.....
..X.X......XXX...X...
..X...XX.XXXXXX......
...X..XX.X......XX...
.X.......X....XXXX...
.......X....X....X...
XXXXXX.........X.X...
XX..X........X....XX.
XX....XX..X.......XX.
...XX.....X...X.X....
......X...XX....X.X..
XXXX..XXX....X....X..</walls>
			</board>