<?xml version='1.0' encoding='UTF-8'?>
<board>
				<level>201</level>
				<width>70</width>
				<height>70</height>
				<walls>......XX....XX..XXXXXX...XX..XXX...X....X..XX...X..XX..XXXXX...X......
.XX......X..XX....XXX..X.XX...XX.X.X....X...X.X.X...X..XXX...X...XX...
....XX.X...X...XX...X.......X.X..X.X..XX..X.X.....X.X...X..X..XX....XX
..XXXX.......X..XXX.....X.......X..X...X.......X......X.X........X....
..XXX.....X.....X..X......XX.X....X..X.....X.....X......XXX....XX..X..
..X...X.....XXX....X.XXX...X...X....X........XX.....XX...XXXX...X....X
....X...XX....XX...X.....X..X..X......XXXXX.....X.X.X..X.XXX..X...X..X
.XXX.............X....X...X.X..XXXXX..XX....X...X...X......X.......XXX
...X.X.X.........XXXX...X.....XX...XXX...XX...XXXXXX....XX.XXX...X....
XX.....X.X......XXXXXX...X.X..XX.X.X...XX......XXX...X......XX...XX...
....X....X.......XXXX..X.X...XX..X...X.......X.XX..X...XX.X.XX...X..XX
.XX.XXX....X...X....X.XX..X..X..X......X.....X....XX...XX......X...XXX
..X.XX..X....X....X.X...X.X..X....XXX..XXX...X...........X.......XX..X
X......X..X.X...X...XXX...XXX...XXX..XXX.....X....XXX.....XXXXX..XX..X
...XXX...XX...X...XXXXXXXXXX..X..XX...X..X....X...X.....X.X...X...X...
.X...X.XX....XXX..X..XXXX..X...X..X.X.X....XX...XX..XX......X...X...X.
.X.X...XX..XXXX...X...XXX......XX...X.........XXX..X...X.....X...X....
...X..XXXX......X...X...X...XX...X...X...X......X......XXXXX...X...XXX
XXX...X...XX...XXX...X....XX...X...X.X.X...XXX...XX.......XXX..XX.....
....X...X....X.X...X...X.X...XXXX..X......XXX..X.XX...X....XX..XX.X...
...X...XX...XX.....XX....X.XX..XX..XX.X.....X.....XXX....X.XX..X..X.XX
XX...X....X.XXXXX..X..X........X...XX...XX......X....XXX....X....X..XX
XXX.....X...XXXXXXXX.X..X.X......X.X...X...X....XX...XX...X...X....XXX
X.....X....XXXXXXX...X.XX...X........X...X...XX.X..XX...XX....XXX.....
...X.....X..XXXXX..X.....X....XXX.X...X....XX...X.XXX......X......XX..
.X...X.XXXX...X...X...X........X..X.X...XXXXX.....XXXXXXX....X.......X
.....X..XXXX....X...X...X.X..X.X....X..XX...X..X..XXX.....X.......X..X
XX....X.X....X......XX..X..X...X..XXX.....X.X....XXXX.......X...X.X..X
....X...X..XXXXX....XX..XX.X.XXX......X...X...X..XXX..XXXXXX..X...XXXX
.XX....XXX....X........XXX.......XX.....X..X....XXXX...XXXX..X........
....XX...XXX..X....X......X...XXX...XX..XX.X.X.......X...X..X..X.X....
..X...XX.X...XXXXX...XX.X...X.....XXX...XX...X.X.........X....XX...X..
..XXX....X..X..XXXX.....X.....XX......X.XXX..X......X.....XX......XX..
X......XXXX.X...XXX.X.....XX.....X....X.....XXX.X.......X.X..X....X...
X.XX.X..X.....X...X...X..X...X.....XX.XX......X...XX.XX.....X..X..X.X.
.....X..X..X...X....XXX....X.XXXX...X.X..X.....X.....X..XX....XX....X.
.X......XX.....X.X......X....X....X.X...X....X...X.....XXXXX.....X....
.X....X...XX...X...X......X....XXX..XX..X.XXX.....XXX..XXXXX...X...XXX
...XX...X....X.......XXX....X......XXX..X.....X.X.X....XXX...XX.......
..XXXXX....XXXXXXXX......X..XXXXX......XXXX..XX.....XX...X....X.X...X.
..XX.....X....XX...XX......XXX....X....XXXX...XX.XX...X..XXXX.....XX..
XX.....X..XX..X..X....XXX....X......X...X...X....X..X.X.XXXX...X.....X
X...XX....X..X..X...X..X..X....XXX..X.X...XX...X...XX...XXX..X...XXXXX
..X.X...X...XX....X..X.X....X.......X..X.....X.....XXX..XX..X....XX..X
.X..X.X.X..XXXXX.....X.XXX....X.....XX...XX..XXXX..XXX..XX....X...X...
.X....X..X....XX.......X...XX......XXXX..XX..XXXXXXXXX..X..X..X.X...X.
.X...X...XXX......XXX....X.......X.XX..XXXX....XX..X....X.......XXX...
...X.X.XXXX..X......X......X...X...XX.......X..XX....XX...X...XX....XX
..XX...XX...XX...X....XXX....X...XX...X.......X...X....X....X.X..X...X
...X..XX.......X...XX.........X..X..X...XXXX....X...XX.X...XX...XX.X..
.X.X...X.X...XX.....X.......X....X......XXX..X......XX..X..XXX..X..XX.
...X.X.....X......X.....XXX......XXXXX..XX..X..X....XXX...XXXX..X.X...
X.......XX..XX....XX....XX..XX..XXXX..XX...X..X.......XX.....X..X...XX
X..XX.XXXXX.XXXX...XXX...X...X...XXX...X.....XX....X.....XX..X..XX..XX
XX.X..XXXXX...X..X..X..X.X.X.X.X.X...X.X....X....X...X.X....X...XX....
.....XXXX...X...XXX...XX...X...X...XXX...XXX..X..XX..X...X....X....XX.
..X.X...X.X.X..XXXX..X....X...XX..XXXX..XXXX....XX....X......X......X.
X.....X.X.......XX..XX.XX.X.X..XXX.....X..X..X..X..XX.X...X.......X.X.
...X.......XX...XX...X....X..X.XX..X...X..X..X....X.....X...X.X...X...
.X...X......X.XX...X...XXXXX...X..XX.XXX..X....XX....X..XX..X.X.XXXX..
..X..X..XXX....X.X..X....XXX..X..X...XXX....XX....XX...XXX..X.....X...
X...XX...X...X.X....X.X.......X......X...XX....X....X.......XX......X.
XX.....X...XX..XXXX.....XX....XXX......X....X..XXX....X.....XXXX......
...X..........XXXXXX.X...X...XXX....XX...X......X..XX...XX......XXXX..
.X...XXXXXXX...XXX...X.X..X..X...X...........XX.X.XX..XXXX.X....XX....
.............X.....X....X...X..XXX.XXXX...X.......X..X...X...XXX...X..
XXX...X.......X.......X...XX..X....XXXXXX...XXXX....X..X.XXXXXX..XX..X
XXXXX.......X.......X..XX....XX...XXXXXXXX..X...XX....X..XX...X.....XX
XXXXXX.X....XX.XX...XX.X.......X..XXXXXXXX....X....X....X...X.......XX
XXXXXX...X..XX....XXXX...XXXXX...XXXXXXXXXXX.........X..X...........XX</walls>
			</board>