<?xml version='1.0' encoding='UTF-8'?>
<board>
				<level>119</level>
				<width>44</width>
				<height>42</height>
				<walls>...XX..X.......X..X.......XXXXXXXXX..X......
.X.....X..XXXX....X.XXXXX.XXXXXX.....X......
.......XX....XX...X.......X......X...XXXXX..
XXX....XXX...X....XX....X...XXX....X..X.....
.......X.....X.XXX....X.....X...XX..X.....X.
...X...X.XX..X......X.XXXX..X.XXXXX....X....
X..XXX......X....XX...XXX...X....XX..X...X..
X.XXX...X...X.X..X...XXXX...XXXX.XX...X.....
X...X......X..X.X..X.X....XXXXXX......X.X...
.........X...XX...XX.X.XX.......XX.X......X.
.X...............X.....XX..........X.X.X....
.X...XXXX..XXX......X.........XX.......X.X.X
...X..X...XXX...XXX.............X...X......X
..XXX...X...X.X...XX.X.......XX...X.X...X...
XXX..XX.......X...XX.X.X...X.....XX.X.X...X.
.....X....X..XX....X.....X.X...X......XXX...
...X...X..XX.....X....XX...XXX.....X.......X
......X...X..X...X..XXXXXX...XX.......XXXX..
..XX....XX..X..X..X........X......X.X...X...
X....X.....XX.....X.........XX.X..X.XX....XX
X.X......XX.......X.......X.XX...X..X..X...X
......XX.XX.X.....X.....X.....XXXX....X....X
.X....XX....X...X.X..X.....X.......X....XX..
.X..X........X....XX...X.....X.XXX.....XXX..
.X.........X...X.XX............XXX..XXXX....
.X.X....X..XXXXX....X...XXXX..X.....XX...XX.
...X.XX...XXXX.......XX.X..XXXX.XXX.....XX..
......XX....X..XXXXX.XX....X....XX....X..X.X
.XX.X....X..X...XXXX.....X.....X...XXXXX.X..
....XXX..X....X..XXXXX......X....XX..XXX....
X.......X..XX....XX....XX.....X......X....XX
X.X....XX...........X..XXXXX.......X....X.XX
X...X........XXXXX.....XXXX..X.XXX....X.X...
XXX...X.XX.....XXX...X...XX....XXX......XXX.
........XX.........X......X.....XX..XX....X.
...X............XX....X.X.....X..XX...XX....
.....X....X......X..X...X..X.....XXXX....XXX
.......XX.XXX..X....X....XX..X....X....XX...
......XXX..XX.....XXX..X.X..X..XX....X..X...
....XXXXXX....XX...XXX...X.XX....XXX....XX..
.....XXXXX.......X..XX......X.XX.XX...X.....
.....XXXXX..........XX....X...XX....X.......</walls>
			</board>