<?xml version='1.0' encoding='UTF-8'?>
<board>
				<level>164</level>
				<width>59</width>
				<height>57</height>
				<walls>.......X....XXXXX....X...X.........XXXX...XX...XX..X.......
.X...X...XX..XX...XX...X...XX...XX..X...X..X.X.X...X....XX.
...X.X..XX...XX...X...........X.XXX.....XX...X...X..XXX....
..XX....X..X......X.....XXX..XX......X....X..XX.....X..XX..
........X....X........X......XXXX..X.X.........XX......X...
.X...........X.....X.....X...XX....X.XXX.......X.......X.X.
.X.XX..X.....X...X...X.X...X..X.XX...XX.....X....X.......X.
.X....X...X....X.......XX..XX...XXXXXX..XXX...X....XXXX..X.
....X.X.X.X.........X.....XXXX.......X.X..X.......XXXXX..X.
X.XXX...X...X...XXX...XX..X....X.....X....X.......XXXXX..X.
X.XXX..XXXX...XXXX....X...X......XX....XX..XXXX.......X....
X.XX...XXX...XXXX..X..X...XXXXX...X....X...XX....X........X
.....X..XX.X.XX...XX.....XXXX...X...X....X.....X...XXX.....
....XXX....X......X..X.....X..X..X..X.XX...X...X..XXX....X.
....X...XXX.......X.....XX.X.....X.X..X....XXX..X.....XX.X.
...XX.X.XXX.......XXX...X.....XX...X....X..XXXX.XX....XX...
....X........XXXXXXX..X...X.X.X.......XX......X..X..X..XXXX
..X....X.....XXXX..X.....XX.....XX....X..XXXX....XX.XX..X..
X....XXX.XX..XXXX....XXX.....XXX.....XX........X..X.XXX....
X.....XX.....XXX..X.......XXXX...XX...X......X....X.....XX.
X.....X...XX...X....X...X.XX.....XX.X.X...X.....X.......XX.
...X..X.X..XXX.....XX.X...X.......X.....XXX.X.X.XXXX...XXX.
.X....X.XX..XX..XX....X.....X...X.XX...XX.....X.XXX..X...X.
..X...X.X...XX..XXX.....XX..X...X.XX...X..........X...X..X.
X...X.....XX............XX....X.X....XXX.X..XX.XX.....X.X..
.....XXX......XXXX.X......XX....X..X......XX...XX..XXXX...X
.X.X...X..X.X......X.X.......X..........X....X.....X.......
...XX..X..X..............XX.......X.XX.........X.X.....XXX.
......XX..XX..XXXXXXX.......X.XX....XX...XXXX....X.XX...X..
..XX...X.....XXXX..XXXXXXX..X....X...X...XX..XX.......X...X
X.X..X...X.....XX....XX.....XXX..XXX......X....XX...XXX..XX
....XX......X...X.XX....XXX...X...X.....X...X..XX...X......
.X...X....X...X...X.......XX....X...X......X..XXXXX.....XX.
.....XX......XX..XX.XXXXX....X.....XX.XX.X...XXXXXXX.X..X..
..X.....X..X..X...X....XXXX....X...XX..X.....X..XXX..X.XX.X
..X..X..X...X...X..XXX......X......XXX.XX....X....X.......X
XXXX.X..X.X......X..XXX.......XXXX.............X....X...X..
.......X..XX..X..XX...X....X....XX..X...XX....X..X...XX....
....X....X....X.XX..X.XXX....XX..XX.XXX.....X...XX.X.......
....X.......X....X....X...X....X..........X......X....XXXXX
...XX.....X.XX.X.X.X......X.X..XXX.X......XXXX.X....XX.....
....X.XXXXX.XX.....X.X......X.XXX..X.....XXX...X..X........
..X.X...XXX...XXX......X.......XX.....XX..XX....XX..X.X....
XXX.....XXXX..XX....X..X...X.X....X...XXX.......X..X..X..X.
XXXX.........XXX.XX...X..X.X.X..X...X..XX.........XX...X...
XXXX...........X......X......X..XXX..X..X.....XX..X....XX..
XXXXX.......X......X......XXX....XXX....XX..........X...X..
XXX.....X...X.X....X...XXX....XX...XX......X...XX..XX.X....
.....XX...X.X.X...X....X.....XX..X.......XXX...XX..X..XX...
...X..X...X.....X...X.....X..XX....X.X.......X.....X.X..XX.
....X........X...XX...XXX...XX..XX...X..X.XX.....X.........
..X....X...X..XX......XX.....X...X....X...XXXX......X....XX
X........X..X......X..X..XXX.XXX...XX..XX......XX......XX..
......X........XXX....X.......X....XXX......X.....XX...XX..
.X....XXX....X..XX..X.......X...X...........X...X....X.....
.XXX...XX.....X..X.....XXXXXX..XX.X..........XX....X...X...
.....X......X....X...XXXXXXXX..XX..........X.....XXXXX.....</walls>
			</board>