<?xml version='1.0' encoding='UTF-8'?>
<board>
				<level>47</level>
				<width>20</width>
				<height>18</height>
				<walls>...XXXXXX...........
.X..X........X..X...
.XX.....XX......X...
.....X..X.....X.....
..X.......X......X..
X...X.XX....XX...X..
..........X....XXXXX
.X...X.XX..XX.......
.X...X...X....X...X.
...X..XX.X..X...X...
......XX..X...XXXX..
....XX....X.....XXXX
.....X..............
.XXX...XXX.....XX...
.XXX.........X......
........X........X..
..XXX.....XXX.X.....
..XXXXXX..XXX...X...</walls>
			</board>