<?xml version='1.0' encoding='UTF-8'?>
<board>
				<level>178</level>
				<width>63</width>
				<height>62</height>
				<walls>X.....X......XX......X........X....X...X.....X..XXXXX..X...X...
X.X.....XXXX..X.XXX....X......X......X...X...X......X....X...X.
X....X.....XX...X...X........XX...X.XX..XX..X..X......XX....XX.
...X.XXXXX..X..X........XX......X.X..X....X...XX...X.X.........
..........X......X...X........X......X.XX....X..X..X....X..X..X
XXX.X.......XXX...XX...X..X..............X.XX.....X...X...XX...
XX..X..X........X..XX..X...XXXXX......X....X..X..XX.XXXX..X..X.
XX...X..XX.......X...XX..X..XX...XXX..X...XX.XX...X...X..XX.XX.
X....XX..X....XX......X...X....XXX...XX.........X.....X.XXX.XX.
X.....XX...X....X...X.....X..........XX...X...X....X..X.....XX.
...XX..X..XX.X....X....XX......XXXX.....X...X....X....XXXXXX...
.....X.X..X....XX....XX......X...XXXX............X..X.X........
..X....XX...X.....XX..X..X.X...........X...X......X.X.......X..
....X...X...XXXX......XX.X....X...X......XXX..XXX...XX.X....X..
......X..........X.XX.......X...XXX.X.XXXXXXX..XXX..XX...X..X..
...X.......XX......XX...X......XXXX.X...XXXXXX.....X..X........
.X.....X........X.XXXX..XXXX............XX...X..X..X...XX....X.
...........X....X...X..XX.....X....X.....X...X....XX.X.....X.X.
XXXXXXX.XX...X....X...XXX.......XX....XX..X..X.X...X..X....X.X.
X..XXXX..X.....XX.XX....X....X.XXX..X.....X..X...X....X...XX.X.
X....XXX....XXX...XXXX....XX...XXX..X..X.....X..XXXXX......X...
X.XX..X...X...X.XXXXX..X......XX....X....X...XXXX........X..X..
X.XXX...X...X...X...X.............X...X....X.X....XX.....XX.X..
X..X...XX.XXXXXX..X.....X.......X....X..X....X.X..XX...X......X
...X.X...........X........X.X....XX..X....X........XXX...X.....
.X.......XXXX......X....XXX...XX..X.X..X.....XX.XX.X.........X.
......XXX.........X..X..XX.X....X...X....XX..XX..X...X.....X...
X...XXX......X.XX.X....XXX...X...X..X.......XX...X..XX...X.....
..X..X..XX.X...XX...X..........X......XXXX..XX....XXXXXX....X..
..XX...XX..X..X....XX.XX....X.........XXX....X..X......X..X..XX
...XX..XX.XXXXX..XXXX.XX.XXXX...X....XX...XX.X.......X....XX...
.X.X...XX..X..X...X...X..X........X..XX....X...XX..........XX..
.X...X.X...X....X...XXX.XX..XX.X....XX...X..X...X.X...XX...XX.X
.X.......X.....XX.......XXX..X.........X....X.X...XXX..XX.....X
.X....X......X....XXXXX..XXX....X....XXXX.....XX..XX...X....XXX
..X......XX....XXX....X..XXXX......X..X......X...XX..X...X.....
X...XX.X....XX...X.XX....X..X...XX....X....X...X.X..X......X...
....XX..X...XX.X...X...X....XX..XXXXX.........X..X....X...X....
.XX..XX...X.....XXXX.X....X..X.XXXXXXXXX..X.X...X.....X.X...X..
.XXX...X......X.XX...X..X..X........XXXXXX..X...X.......X...X..
..XX....XX.X.......X....XX....X..X......X..X.........X.X....X..
X..X..X....X...X...X..XXX...X....X.X.XX...X..X...XX..X...X..X..
...X...X....X..X.X....XXX.X...XX.X...XXX....XXXX....X....X....X
.X...X.X..X....X....X.X...XX.....X.....X.X.....X...XX......XX..
.....X..X.XX...XXX..X....X.....X.......X.X.X.....X...XXXX...XX.
X.....X...X....XXX.X...X.X........XXX....X....X.XX.....XXXX....
....X.XX....XXXX.....XXX........X.X...X.....X.X.XX..XX........X
......XXXX.......XX...X...........X..XXXX.....X...XX..........X
XXXX..XXX..XXXX..X..X...X......X...X....XXXXXX....X.........XXX
XXXX..XXX..X.....X........XX...XXX..X.......X..X....X.....X....
.....XXXX....X...X...XXXXX....XXXXX...XX......X....XXXX......X.
.....XXXX...X......XXXX.....X...X......X...X....X...XXXXXX...X.
....XXXXX.....X...X.......X.......XXXX...X...X....X...X....XX..
.X..X.....XX....X.X.XX.X..XXXX.....XXXX...XX...XXXXXX...X.....X
...XX.X......XX.X...XX.X.XXXX....X.X....X...XXXX.....X....XXXXX
X.....X..X.X..X..X..XX.....X..XX.X...X..XXX......XXX...X...X...
X......X.X....XX....X...X..X.........X..XX..XXX....XX..X.X...X.
X...XX.X....X.....X...X...XX..X...XX.....X..X.......X....XX....
X.X..X....X...X.XX........XX....X.X...XX......X...X.....X...X..
X..X..X...XXX...X..XXX....XX.XX.X...X.XXX..X....X..XXX......X..
...XX...XX...X....XX......X..XX.....X.X....X.X..XX...X.XXX.....
...........X...X..XX......X.........X...XX...X..XXXX...XXXXX...</walls>
			</board>