<?xml version='1.0' encoding='UTF-8'?>
<board>
				<level>124</level>
				<width>45</width>
				<height>44</height>
				<walls>XX...XX....XX...X..XXXXXX...XXX....X........X
...X.X..X...X.X....XXXXXX.X.X......X..XXXXX..
.X.....XX.X...XX...XXX....X....X...XX.X...XX.
....X.....XX.......X.........X...X.X....X.X..
X...X..X..X....X......X....X....X..X.X.XX...X
..X..X.X....XX....X...X..X....X.X......XX....
..XX.X...X......X.XXX....X..X.......X...X.XX.
.....X....X...X...XX...X..X....XXXX...X......
........X...X.XX..X..X.XX..X..XXXXX......XXXX
XXXXX......XX.X..X..XX...X....X......X......X
XXX......X....X....XXX........X..XXX......X.X
XXX.XXX....X....X.........X....X..X...X...X..
..X..XX.X......XX.X...X........XX...X.....XX.
.....XX.X...XXX.....X......X...X...XX.....XX.
...X....XXX.X....X.....XXX.....X.X...........
..........X...XX...X.XX..........XXX.....X...
XXX.X........X....XX....XXX.........XX...X.X.
X...X......X...XX....X..XXXXXXX........X.....
X.XX.....X.........X..............XX.X....X..
X....X...X..XXXX....XXXX.....X....XX....XX...
..X......XX....XXXX..XXX.XXX.X........X....X.
....X.XXXXX....XXXXX.X....XX.......X....X....
.X....X..XX...XXXXXX....X.X........X...X....X
.X.X..........X..XX..XX.X.X....X...XXX.X.X...
.X...X.....X..X...X...X.X.XX...X....X....X.X.
..XX.....X.X....X.X.X...X.XX..X...X...X....X.
X..X..X......X......XX....XXX...X.......X..X.
...XXXX.X......X.......X..XX.....XXXXX..XXXX.
....XX..XXXXXXX..............XXX..XX...XXXX..
XXX....X...XXXX.....X...XX..XX..X.........X.X
XX.......X...XXX......X..X...X......X...X...X
XX......X....X...X...XXX...X...XX.....X......
XX......X........X..........X..............X.
X.....XX.....XX....XX..XXXX...X..X...XXX...X.
..X.X..X.XXX....X...X......XXXX....X..XX..X..
.X..XX.X..XX..X.X.X...XX...XX...XX....XXX...X
...XX..XX..X..X.X....X....XXX.......XX.....XX
X.....XX...X..X....XXX..X...X..XXXX.....XX.XX
X...XX...XXX..X..X......X...X....X....X....XX
XXX....XX.....X.......X.X.....X....X........X
XXX..XXXX...X...X.XX....X.......X.X..XXXXXX.X
................X..X.X....XXXX....X.XX..XX..X
.XXXX....X...XX..X...X...X...X.......X...X...
......XX...XXXXX.......X...X.......X...X.....</walls>
			</board>