<?xml version='1.0' encoding='UTF-8'?>
<board>
				<level>175</level>
				<width>62</width>
				<height>61</height>
				<walls>....XXXXXXXX.....XXX...XXXXXXXXXXXX...X...XXXXXX...XX.........
.XX.......XX.XX....X.X...XXXXXXXXX..X...X....XX..X....X.......
.XXX.........XX.X....XXX.........X.....XX..X....XXX...X...XXXX
.X.....X...XX.....X................X....XXXX..X.....X.X.......
........XX.....X....X..XX.......X..XXXX....X..X....XX....X....
XXX...X.....XX...X..X.....X.....X...XX.....XX....X...X......XX
X...XXX..XX..XX....XX...XXX....XX.X....XXXXX.....X...X....X...
X.XX..X....X....X..XX........X....X..........X.X.......XXXXXX.
..X...X.XX....X.X...XXXXX..X....XXX.......X..X....X.....XX....
....X.....X.......X...XXX...X....XX..X....X.....X....XX.XX.X..
XXXXXXXX.....X...XX...X...X......XXX...X..X...XXXXXX....X.....
XX....X..X...X.XX.......X....X.........X..XXX.X...XX..X...X...
XX.XX...X....X.......XX...XX........X.......X...X.X...X....XXX
...XX.....X....X..............XXX...XXX.........X...X....X....
.XX....X....X....X...X.....XX..XX..XXXXXXX......XX.......X..X.
.....X...XX.X......X.....X.....XXX.............XXX...X....X...
XXXX....XX..X.....XX..X......X..XXXXX....XX....XX....X.XX...XX
XX....X....XX...XXXXXXX.X.XX.XX....XX..X.XX.X..XX......XXX....
X..XXXX...X...X....XXXX.X.XX.X..XX..XX.X....XXX...XXXXXXXX.XX.
X...X.......XXX.XX.XXX....X..X....X..X..XXXXXX..X..XXX.....XX.
..X......XX.....XX.....X.XX.XX.......XX.....X..XXX.....XX.....
...X...X......XX..XXX....X..XX...XX...XXX...X....XXXXX..X..X..
.X.....X.X.....X...XX...XX.XX..XX...X..........X...XX...XX.X..
.........XXX.X...X....X..X.X..X.......XX...XX..XXX....X......X
X...XXX..XXX....X...X.XX...X.....X....X....X..XXX....X....XX.X
..X...X..XX...X...X...XXX......X.X......X....XX...X....XXX...X
.XX.......X.XX....XX...XX...XXX......XXX..X...X.XXX.X.........
..X..X......XX.X...X.X...XX.....X........XX.X.X...X.......X.X.
X....X..XX.......X.X..XX.....XXXX....XX...X.......XX...XX.X...
XX.X..X.......X.......XX..XX......XX....X.XX...XXX...X..X.XX..
XX....XXX..XX.....X....X..XX..XX......XX.....XX......XX.....XX
....X......X........XX....XXX.......X....X....X...X......X....
.X..X....X...XXXXX....X...X...X...X.XXX..XXXX..X....XX.....X..
...X..X.....XX..X..X....X.....X...X.XXX..XXXXX...X.X.........X
..X..X..X.X..X....XX.X...X......X.X.....XXXXX....X....X....XXX
....X..X..XX.X.....X...X...X.XX.X..X....X..XX.X.....X...X.....
.XX...XX...X....XX....XXX..X.......X..XXX..X..X.X.........X...
.........X..X...XXX...XXX.X..X...XXXX...X....XX........XX...XX
XX.....X..X....XXXX...XXX.X....XXXX.......X......X...XX.....XX
X....XXXX.XX.X......XXX.....XX......XX......XX.XXX.X.X........
X.XXXX..X.XX.XX..........X........XXXXXXXX..X..XX..X...X...XX.
..X.....X..X..X.XX.....X....X...X.X...XXXXXXX.....XXXXXXXX..X.
.........X....X....X...XX.X...X.....X....XXXX....XX......XX...
...X...X.X..XXXX.......XX....X...XX....X...XX....XX........X..
...X..XX..XX.......XX..XXX...X.X..X....X...XX...XXX...X....XXX
..XX....X.XX.XX.....XXXXX..X....X......X....X.X.X...X...X.....
.....XX.X....X....X...........X...XX......X...X...X.......X...
...XXXX........XXXXXXXX...XXX.......XXX...X....XX....X...X....
....XX........XX....X...X...X....X..XX..X......X...X.X.X...X..
XXX........XX....XX...XXXXX....X...XXX.....X.....X.X...X...X..
XX......XX......XXXXXX......XX......XXXXXX.......X..X........X
X..XXX..XXX.......XX...XXXX.......X...XX....XX...XX...X.......
X...XXX........XX.XX.X.......XX....X.....X.........X........X.
....X....X.X...XX..X.....XXX..X..X...X........X........XXXXXX.
.XXX...X.X...X...X....X..XX...XX.XX.......X...X...X.....XXXX..
.X...X...XX..XXX....X...XXX.X.........XX.....XXXX.....X......X
...XXXX..XX..XX...X.....XXX.X...X.XXXX...X.X...X...XX........X
X......XXX......X.......X...XXX.X.XX.....X.......X.....XXXXX..
..X....X...XXXX...XX....X.XXXX..X..X..X..XX...X......X...XXXX.
....X....X...X....X.....X..XX..X...XX.X..X....X.X.X......X....
XX..X......X...X..X.....XX....XX......X..X......X...X......X..</walls>
			</board>