<?xml version='1.0' encoding='UTF-8'?>
<board>
				<level>97</level>
				<width>36</width>
				<height>35</height>
				<walls>......XX....XXXXXXXXXX.....X....XX..
.X..X....XX.X............X....X.....
.X.......X..X......XX.XX.XX.X.XXX...
...X.....X...X..X.....XX.XX.X.XX..X.
..XX.XX...XX....X.X.XX...X..X.......
.....X..X.....X...X......X...X...XXX
.XX..X.....XX.....XXX......X.X.X...X
..X...XXXX.....X..X..XX....X.......X
X.X.X...X....X...XX...........X.....
X...XX....X......XX.........X.......
XX...X.X....X....X.....XX.X..X..XX..
XX.X.X.XXX....X..X.XXX.XX.......XX..
X....X...X.......X...X....XX..X.....
..X.XX.........X...X....X..X......X.
.XX.....XX...XX.......XXXX...XXX....
.....XX....X....X...XX......XXX..X.X
XX...XXX..XXXX....XX...XX.XXX...X..X
XX.....X..XXX....X........X....XX...
....XX.X......X.....X...X....X.XXXX.
..X......X....X.X.X...X.X..X.X.XXX..
X...X.X..X.XX.....XX..X..X.X.X.....X
XX..X....X.X..XX.XXX.XXX...X.XX...XX
...X...X...X.........X.....X....X...
.XX..X..X.....X...XXXX.....XXX....X.
.X..XXX...X.X............XX.........
...X........XXXX.X..........XX.....X
XXXX.X...X...XXX...XX...X......X.XXX
.....X.....X.......XX.X.......X..X..
...XXXXXXXX.....X.....XX..XXX...XX..
...XX...XX..XXX.XXX.X.....X....X....
....X.X.XX.X..X.XX..X..XX...XX......
..X...X..X....X..X...X.....XX..XX...
..X....X.XX...XX...X..X....XX.......
.....X.X....X..X....X.....XXX...XXXX
...X...X..X....X..X....XX.....XXXXXX</walls>
			</board>