<?xml version='1.0' encoding='UTF-8'?>
<board>
				<level>172</level>
				<width>61</width>
				<height>60</height>
				<walls>.....XXX......X..X..XXXXXXX...X...X..XX......XX............XX
...X.......XX....X..XXXXX...X...X....XX....X..X...X....XXX..X
............XXXX....XX........XXXXXX.XXX...XX.X.....X.......X
..X.......X..XXXXXX....X.............XXX...XX....XX...X.XXX..
..X...X...XX......XXX....X...XXX....XX.........X.....X..X....
XXXX....X.....X...XX..X....X........X..XX...X....X.X.X.......
.....X.XX.X.X.....X..XX.X.XX.XXXX...X.XXXXX...X....X.XXXXX...
.....X....X...XX..X.....X....XX...X.......XX....X....XXX.....
X................X...........X..X.XX...X..X.......X..XX..XXXX
X.X...XXX..XX..X...XXXXX.....X.......X...X..X.....X..XX......
X...X......XXX....X..XX..XX..XXX.X.......X...........X....XX.
X.....X..X.....XX....X..XX.....X....XXX..XXXXX...X.....XX.XX.
X..X..X......XXXXX...X.X...XXX..X.X.....XXXXX..X...XX........
XXXX.XX...XX....XXXX...X....XXX.X.XX....XX..X.........XX.XXXX
........X...X...XXXXX.....X..XX...XX...XXX....X...XXX..X..XXX
...XX.....X.....XXXX....X....XX....X.......XX.XXX..XXX....X..
X....XXX....XX..XXXX.XX.......X.XX....X....XX.XX...XXX..XX...
X.X......XX....XXXXX..X...XXX.....X.XXX..X.XX..X.XXX.....X.X.
X...XX....XX...X..X...XX..XXXX......X..X.X...X.X.XXX...X.....
X..X...XX..X..XX..X.XXX..X..X....X.....X..XX...X.XXXXX.XX...X
XX...XXXXX.XX.XX....X...XX....XXXX.XXX..X...X....X...X....X..
XX......X..X..X..X.....XX..XX...XX....X.......X....X....X....
....XXX.X....X..X..X.X..X.XXX.X.XXX...XX...X....X.....X.X..XX
.XX..XX...X....XX.X..XX.X..X....X.....XXXX.....XX.XX....XXX..
.XXX........X.......X...XX...X....XX....X...X..X..X..X...X...
.......X.X..XX...X......XXXXX......X.X....X...XX....XXXX...X.
X...X....X.XXX.X.XXX....XXX...XX.....X.X....XX.....X...XXXXX.
X.X...X........X.....X....X.X....XX......X.....X.....X..XX...
..........X.....XX...X....X.....XX..X......X.....XX...X....XX
.X.....XXXX..XX....XXX.......XX.XX....X.........X.....X..X...
.X..XX.XXXXX....XXXXXX........X....XX.X.....X...X..........X.
.X...X..XXXXX........X........X.......X.XX...............XX..
.X.X....X...X............X....X..XX..XX.XX...X.........X....X
...X..XXX.X.........X.......X.XX.XX...X..XX.......XXXX....X..
..XX..XXX.XXXX...XX.....X.X.X.......X.XX.X..X...........X....
XXXXXXX..........X...XX.X.X....XX.XXX....X.XXXXX.X....X...XX.
.........XXX...XXX.X..X...X..X....XXXX........XX....X.....XX.
.......X...X.X........X..XXX....XXX....XX.XXX.....X...XX..XX.
.........X...XX...X....X..XX..X..XX.....X...XX..........XX...
......X...X.....X...XX.X..XXX....XXX..X.XXX.X....X.........XX
..XX..X.X...X.X.....XX....X....X......X.X...X.X....X...X.....
XXX..XX..X....X.XX....X...X....X....X...X.......X....XX..XXX.
....XX...X.X............X....X....X....X...X...X..X.....XXX..
...XX..XXX.....X.....XX......X..XXX..X...X...X...XXXXXXX....X
X..XX...XXX......X....X..XX.....XXXXXX..X.............X..XX..
..XX..X..X..XXX..XXXX.XX....XXX..X......X...X.....XX..X.XX...
.XXX.....X.X..X..XXXX......XXX...X.XXXX..X....X...XX.XX.X..X.
...X...X...X....XXX...XXX...XX........XX...X...XX.......X.X..
.....X.......XX.....X.XX..X.X.....X.X...X....X....X.........X
..X....XX...XX...XXX.....XX...XX..X.X.....X.....X....XXX...XX
XXX.X..XX.XX...X.....X....XX.....XX....XX.....XXX..X...XXX...
X...XXX...X......XX.....X..X....XX...X...XX....XXXXX.....XXX.
X..XXXX.....X.....X...X....X..X..X.....X....XX........XX..X..
XX......XX..XXX.X.........XX..XX...XX..XXX..XX....XXX...X...X
XXXX..........X.XX....XX..XXXX.....XXXX..X.....XX....XX.XX...
...X.X..........XX..X....X.....XX.....X......XX....X.XX....X.
.X...X..XXXX.....XX...X..X.....X..X.....X....X...X....XXX..X.
...XXX.....XXXXX.XX....XXXXX...X.XX..X....XX.X.X.X..X....XX..
....X..XXX.....X.....X.....XX..X...X.....XXX...X....X..X.X..X
..X...XXXX..XX.......X..XX.........X..XX............X..X...XX</walls>
			</board>