<?xml version='1.0' encoding='UTF-8'?>
<board>
				<level>112</level>
				<width>41</width>
				<height>40</height>
				<walls>XXXXX.........X..XXX..X........XX.......X
............X....X....X.XXXXXX..X....XX.X
..XX...X....X..X...XX...........XXX.....X
X..X.X...X..X..XX......XX...XXX.....X.X..
XX...X.....XX....XX.......X.X.......X.X..
XXX..X......X.XX..........X....X....X....
.....X....X...XXX..............X.X..XX...
...X.........X..X.X....X...XX..........X.
XX...XX..X......X...XX.XXX......X.X..X...
.....XX..XXXX...X....X....XX.X..X....X..X
.XX....XXXX..XX......XXXX..X...XXX...XX..
.X..XX...XX......X..XXXXXX....XX...X.....
.X...X......X..X....X.......X........X...
...X....XX.....X..X...XXX...XXX...X....X.
XX....X....X...XX....XX...X..XX.....XX.X.
XXX.....X..X...XX..X..X......X.....X.....
.......XX..XXX.X...XX..X...X...X........X
.....X...XXXXX...X..XX...X...XX...X...X..
X...................XXXX........X...X....
X...X...XXX...XXXXXX........X............
......XXX...X.X..XXX....X...X...XX...XX..
.X.XXX......X....XXXX...X...X....X.......
.X.......X.......X......XXX.X..X.........
......X..X...XXXXX..XX..X...X.....XXXXXXX
..X...X.XX...XXXXXX....X..X...X....X.....
XXX.X...X....X.......X.X......X....X..XX.
........X....X...X.XX..XXXXX..X.XX..X....
.XXX....XXXX..X..X....XXXX..XX..X...XX...
.......X....X...X............X....X..X.X.
XXXX...X.XX..X....X..XX....X......XX...X.
.......X.XXX...X.....XX.XX....X........X.
.X..X..X...XXX.....X........X..........X.
.X...XXXXX......XX.XXX...XXXX.XX..XXXXX..
...X.....XXXX...XX.XXX...XXXX.XXXXXXXX..X
X...XXX.......X..X.....X..XXX...XXXXXX...
..X.....X.XXX.XX.XXX....X....X.....XX....
.X...X..X.....XX......X......X.X.X..X.XXX
...X...XX..XXXX.....X............XX.X....
..XX........X...XXX.XX...XXXX........XXX.
..XX..XXXXX...XXXXX....X...........X.....</walls>
			</board>