<?xml version='1.0' encoding='UTF-8'?>
<board>
				<level>159</level>
				<width>56</width>
				<height>56</height>
				<walls>......X...X.....X......X..XXXXX.....X.....X....XX...X...
........X...XXX.X....X....X.........X..XX.X....X..X...X.
XX............X..X......X...XX.X....XX....XX...X.XXX..X.
X..XX....XX......X..XX......X..X.XX...X...X..X...XX..X..
..XXXX.XXXX.........XX.X....X.X..X....X.X...X....XX....X
.XXXX..XXX....XXXXX.........X.X.XX.......X....XX....XX..
....X......X........X...X.....X.....XX.X.....X....XXX...
..X.X.....XXXX.XXXX...X....X........XX....XXXX......X.X.
X...X.......XX...........X.........XX...X...X.....X...X.
..XXX...XX...XX....X.............X..X.X...X...X.X....XX.
.XXX..X.X..X....XX.....XX......X.XX...X....X..X..X...XX.
.X...XX...XX..X...........X....X...X.....X....XX....XX..
.X.......X........X...X.XXX.X..XXX...X...XX...X...X.X..X
.....X.........XX...X...XXX..XXXX..XX..X.....XX.XXX...XX
.....XXXXXX.....X....X...XXX...XX.....XX.X.X....XXX.....
....XXXXXX......X..X.X.X..XX....X........X....XXX.....X.
..X...XX...X.....X.X......XX..X.....XXX..XXXX......X..X.
..X....X.XXX...X.....XX....XX....XX...XXX..X...X...X.X..
XXX..X.X.X.......XX......X.......XX....XX....X.XXX...X.X
.....X.X......XX....XXXX.XXX.....XX..X....XXXX...XX..X..
...X......X...X...XX.....XX....XXXX..XXX.............XX.
...XX...X...X...X.......XXX.....XXXXXXXX.X...XX...XX....
......X....XX.XX....X.........X.X..X.....X......X.....XX
..XX...........X.XXXX.XX........X.......XX..X.......X.XX
.....X.......X.X....X..X...XXX......X.X..X.....X.X..X...
..X......XX....XXXX.XX...X......XX....XX...XXX.X.X.XXXX.
X...X.XX......XX....XX....X.....XX.............X.....X..
......XX..XX...X.X...X..X.....XXXX.....XXXX...X...XX...X
.X...X..X....X.X...X.XX....X..X....XX.......X...X.....XX
.X......X..X.......X.....X...X..X.....X......X....X...XX
.XXXX...X.......X..XXX.........X....XX....XX.X.X..X.....
...X....X.....XXX.XXX.......XXXX.X.....X..XX...XXXX.....
XX...XX..X............XXXXXX..XX...XXX...XXXXXXXXX..XXXX
.........X..X...XX......X.....XX....XX..XXXXXX..XX.XXX..
.XXXXX...XX...X..XXXXXX...X...XX..X.XXX....XXX...X......
...X...X.....XXX.......X..XXX..XX...X..X.......X........
.....X.....X..X...XX.........X.X.......X..X.XXX...XXXXXX
....XX..XX......X..X..X.XXX..X....XX...XX.X.....X...X...
.........X..X..X...XX...X...X...X....X.....XXX....X...X.
......XX.XX.X....X..X.....XXX......X.....X..X..X..XX..X.
X.....XX......X.....X.....XX.....XX...X...X...XX.X....X.
X....XX....X....XXX..XX......X......X...X....X.....XX.X.
...X....XX...X....XX.....X.......X......XX........X...X.
.X.XXXX........XX..XXXXX....X.X..XXX.X....XXX...........
.X......X.......XX.....XX.X.X...XXX..X.X...X.....X.....X
...X...XX..XXXX..XX.....X...........XX...X...X.......X..
.....X....XXXX...XX.X.X..X...XXX....XX............X.....
....XX....XXX..X....X..X..XX...X..X.............X...X...
....XX...XXXX.XX.X.....XX.XXXX.XX.....X...XX.......XX...
..X..X......X.X......XX......X.....XX...X..X.....X.XXXX.
.....X..X...X...X........X......XX.....XXX.XX....X......
..XX.......X...X.......X......X....X.X..XX....XX.XX.....
X...X....X...X...XXX...XX...X......X.XX......XXX....X...
......X.....XX.......XXXXXX....X..XX.X...XXX.....X..XXX.
.X.......XX.....X...X...XX...X.X...X...X..XX..XX.....X..
.......X......X...X...X....XXX...X........XX..XX..XX...X</walls>
			</board>