<?xml version='1.0' encoding='UTF-8'?>
<board>
				<level>82</level>
				<width>31</width>
				<height>30</height>
				<walls>....X.....X....X....XXXXXXXXX..
.XX.....X...XX.X..X.X..........
...X.......XXX..X.X.......XX...
X....X...X....X...XX.X.........
..X....XXX..X.XXXXXX.....X.XXXX
.XX......XXXX............X...XX
.XX....X..XXXXXX....XX.....X...
....XX....XX.....XX.....XX.....
......X..XXX....XX..X.XXXXX....
......X..XXXX...XX....X........
XXXX.....X....XX...X.....X.....
.......X.X.X..X..X...X.X...X...
....X....X.X....XX...X......XX.
..X.X.X.XX.XXX.......XX...X.X..
....X.X....XXX....X..XX...X...X
.X........XXX..XX.XXXX....X....
...X........X........X.XXXX....
XX.......X.......X.....X..XX...
....X..X...XXX.....XX.....X..X.
..X..XXX..X............XX...X..
X....XXXX...X.X...X.........X.X
X..XXX.....XX...X....XX.......X
...X...X.X.....X...X.....XXX...
.X.......XXX.....XXXX....XX....
.XX.....XX...XX...XXX...XX..XXX
...XX...XX.....XX..X.......X...
......X.....X..XXX...X...X...X.
....X.XXXXX...X...X..X.......X.
.........X....X.X.....XXXXX....
.....XXX...XX...X..XX.........X</walls>
			</board>