<?xml version='1.0' encoding='UTF-8'?>
<board>
				<level>63</level>
				<width>24</width>
				<height>24</height>
				<walls>.....X...XXXX...X...XXXX
.......X......X...X..XXX
..X...XXXXXX.....XXX....
..X.X..X...X.X.XXX....X.
..X....X.X.....X....X...
.....X.X....X.XX..X.X...
.XXX.X..XXX.X..XX.X.....
.X...XX.X......X........
.....X..X.XX.....X......
..X..X....X..........X..
..XXXXXX..X.XXXXXX.....X
.......X..X...XX....XX..
.X..........X....XX.XXX.
........XXX......X..X...
..X.......X........X....
....X.....X.....X....X..
......XX.....XX.........
.X.......X.X............
.X..XXX..X.X.X.......XXX
.X...X.....X.X.....X....
...X...X..XX.X...X..X...
XX..X.....X..X.X....X.XX
....X.X...X.X..X.XX...XX
......XXX...X....XXX..XX</walls>
			</board>