<?xml version='1.0' encoding='UTF-8'?>
<board>
				<level>135</level>
				<width>48</width>
				<height>48</height>
				<walls>.....X..XXXXX......X......X.....X...X....XXXX...
..XX....XX....XXXX...XXXX.X.XXX...X......XXX..X.
X..X..X......XXX.....X....X..........X...X...XX.
XX.X....X.X......X...X.....XX..X...X...X.....XX.
XX...XX.X...X......XXXX..X..X..X.X...XXXXXX..XX.
XXX...X.XX....X...XXXXX..XX....X.XX........XXX..
....X...X.......X.XX..X......X.X.XX.X......XX..X
.XXXXX..X......XX..X....XXX..X...XX.......XXX...
.......XXXXX....XX...X......XXX..X.....X.....XX.
X........XX..XX..X..XX..XX..X......XXX...X.X.XX.
X.....X...X..X...XXXXXX..X....XXXX.....XXX......
XXXX....X.X....X..XXXXXX...X....XX..X..XX...XXXX
XX...X......X.....X...........X.XXX.X..XX.X....X
XX..XXXX........X.X...XXX...X...X......X..X..X.X
XXX....X.....X..X.XX..XX..XXX.....XX...X...X.X..
XX...X...X.....X..X..X...XXXX..X..X......X......
...X..X....X..XX....X..X..XXXX...X..XX...XX...XX
.XXXX...X..X...XXX..X.....X......X.......X..X...
.XX..X....XX.X.....X....X.....X....X..X..X......
..X..X.X..X..X..XX...X..........X..X....XX...XXX
X.X....X.X..XX...XX....X.....XX...XX.X..XX.....X
..X...X..X...X...XX...XXXXXX..X.XX...X.XXX..XX.X
.XX.....X....XXX......X.....X....X.XXX...X.....X
.....X....X......X....X.X......X.X..XXX....XXX..
X....X...X....X....X....X.XX........XXX.X...XX..
X.X..X.X...X....X....XX.......X.X.....X...X.....
....XX.......X....X......X..X.X.......XX........
.X..X...X...X..X.X....XX....X....X.......X.XXXXX
.X....X.X...X.XX.X.X...XXXX..X..........XX.X...X
.X.X......XXX..X.....X.....X...XX.....X..X...X.X
...X.X.XXXXXXX....X...X.......XXXXX...XX..X..X..
X....X..XXX..XXXX...X.X.X.XX..XXXXXXX..XX....XX.
..X.....X....X......X...X....X...XXX...XXX......
.X..X.....XX.....X.............X...X.X...X..X.XX
.X....XX..X...XX...X.....XXXX..XX..X.X.X.XX...XX
...XX..X....XX.....XX..X..XXX..XX.XX.X.X.....X..
X....X...X..........X...X......XX....X..XXXX....
X..X........XXX...X...X....X.X........X.....X...
XX.X..X...X.....X....XXXXX...XX..XXXX..XX.....X.
...X....XXX..X..XX.XXX..XX....X..XXX...X........
.XXX...XXXX....XX..X....XX.XX....XX..XX..X.....X
...X.XXX....X...X.XX.XX....X..XX..X.....XX.....X
XX...X.....X..X...X..X...XXX....X.........XX....
XX......X....XX..XX.X..X.XX..X.......X.X..X...X.
...XXXX...X...XXX.....X.....XX.X.X...X...X..X...
..XXXX...XXXX.X...XX....X....X.X...XXXX....XX..X
X.X....X....X.......XX...XXX....X...X.......X...
X...XXXX..X......XX....X......X...X...XX....X...</walls>
			</board>