<?xml version='1.0' encoding='UTF-8'?>
<board>
				<level>84</level>
				<width>31</width>
				<height>31</height>
				<walls>...XXXXXXXX......XX............
............XX......XXXXX..X...
..X.............XX.........X...
..X..XXX......X.XX......XX.....
..X...XX..XXX.X..XXXXX..XXXXX..
....X....X....XX.......XXXX...X
...X...X.....XXXXXX...XXXXX.X.X
.X...X..X......XXX..X....XX....
........X...X....X.XXXX..X...X.
XXX...XX..XX..X....X....XX.....
XX..X....XXX.XX........XXX....X
XX....X.............X..XX..X..X
...X....X.....XXXX....XXX.XX.XX
.X...X......X....X..XXXX..X..XX
.X............XX..X....X....XXX
.X..XXXXX.........XX.....X.....
.....XX......XX............XXX.
XXXX..........X...XXX...X..XXX.
XXX....X......XX..X...X....XXX.
..X.XX...XX..X...XX.....XX.....
....XX.......X.XX....X........X
...X.....X...X.XX......XX.....X
.XX...XX...X...XX...X........XX
....X..XX..XX.....X.XXX..X.X.XX
XXXXXX....XX..X..XX.XXX....X..X
XX.........X.XX..XX.XX..X..XX..
X..XXXXXXX.X.....XX....X...XXX.
X...XXXX...XXX...XXXX....X.....
....XXX......X...X....X..XXXX..
.X......X........X.X.....XXX...
...XXX..XXX........XXX...XXX...</walls>
			</board>