<?xml version='1.0' encoding='UTF-8'?>
<board>
				<level>232</level>
				<width>81</width>
				<height>80</height>
				<walls>......XX..XXXX..........X......X...X..XX.........XX...X..X...X...X...XXXXX...X...
......XX..X.....X...XXX...X..X...X.X..X..X.....X..X.X.X....X...X.X.X...XXX.....X.
..XX..X...X.X.X...X...XX..X....XXX....X.XX........X...X.....XXXX...X.....X..X.XX.
XXX...X.X...X.X..XXX..XX....XX...XX...X..X..XXX....X......X..XXXX.....XX.X....XX.
X...X.......X.XX...X.X...X....X.......XX.X.....XXX...X.......X..X........X...XXX.
.........XX.X....X.....X...XX...X......X...XX.....X......X......XX......X..XXXX..
.X...X....X.....X...X.XX..XX...XXXXXXX..X..X..X.X...X.XX.....XX.......X...X.....X
...X...XX....X....X.X..XX.XX.X....X...X....X.X..X......X..X.....X...XXX..X.....XX
......XX...XX..X.....X.......X......X....X.....XX....X....X.X.X.....XXXXXX.X.X...
..X...X..XXX..X....X.....XX..X...X.XX..X....X...XXX.....X.....X..X......XX...XXX.
X...XXX...XX.X..XXXX..XXXX...X.....X....X...XXX.XX..X..XX....XXXXX....X.XXX....X.
X.......X......XX..........X....XX......X..XX...XX.....XX.....XXXXXXX.X...X.XX...
.....XX..XXXX.X.......XXX.....X.....X...XX..X....X..XX.XX...X..X...XX.XXX.X...X..
.X...XXX...X..X..X....X...XXX.....X...X.XXX......X...X......XX...X......X..X..XXX
...X.......X.....X.X..X....XXX....XX..X...XX.......X....XX..XXX......XX.XX...XXXX
....X...X...X..X...X.......X...X..XX......XX.XXX...XX......X..X...X......XXXXXXXX
..X...X...X.X...X..XXX.........X..XXXX.XXX...X...X.XX......X....X....X.X.........
XXX..X...XX...X.XXXX...XXXX....X..X..X..X..X...XXX........XX.X.....X.X....XXX....
.......X..XX.........X.....XX.....X..XX......XX....X.........X.X.....XX.......X..
..XXX.....X..X.X..............X...X......XX.....XX...X............X.....X....XXXX
X.....X.....XX...X....X...X.X..XXX..X..X....XX..XXXX.XXX...XX...X.X.XX..X........
XXX..XX....XX......X....X.X.XX.....XX....X...X..X....XX..X.XX...X.X.XX.XX.....XX.
.....XXX...X..XXXX.X........XX..XX..X......X....X...XXX.......X.....X..XX.....XX.
.X...X....XX....X....XXX.....X..XX...XXXX..X..X..XX....XX.X......XX...XXX...XX...
..XX....X.XXXXX...X...X...XX.XXXX..X.......X...X..X..X.XX...XX......XX....X.....X
X....XX...XX..XX..X.X...X.XX..X...XX.........X.XX....X.....X...X...X...XXXX.X.X.X
...X...XXXXX...X..X........XX......X.....XX........X....X..X.....X.X....X.....X..
.X.X.........X...X.......X.....XXX.X..XX....X...X.....X...XX..X.......X....X...X.
.X....X..X...X.....X....XX..XX..X..XXXXXXXX...XX..X......XXX..XXX...X....X.XXX...
....XXX..X.X....XXX..XX.XXXXXX..X...X...XXX....X.XXXXX.X..XX......X............XX
..XXXX...X....X...X...X.....XX...XX.....XXX..X.....XX..XX.XX.XX..XX.XXXXX.X....XX
XXX....X....X...X.....XXX......X.X...X..XXXX....X..XX........XX..X..X..XX....XXXX
XXX.XXXXXXX........XXXXX.....XXX...X....XX..X.....XXXXXX...X.....X.XX...XX.X.....
....X......X...X.....XXX.X....XXXX...XX.....X.XX....XX...XXX...X......X....XX....
...XX..........XXXXX.....X..X.XX.....X...XX...XX.XX....X..........X......X......X
....X....XX......XXX....XXXXX.X..XX..X.X......XX..XX.......XX...X....X.....X.....
..X...XX.XXXXX.......XX.....X...X...X..X..X...X...XX.XX.......X....X....X..X...X.
..X....X..XXXX..X...XXXX..X.....X.X.X.....X.XXX......XXXX.X......X....X......X...
..X....XX..XXX..X.X.X..X..X..XX...X.....XXX.........X..X..X.XX.X....XXXX..X......
...XXX..XX........X....X..X...X....X.............X..X..X.....X..X...X.....X.X....
...X....XXX....X.....X....X.X.X..X.............X.X.XX...XX.X.XX...X.X.X...X...X..
X....XX.X...XX.X...X...XX.....XX.XX...XXX....X.X...XX.X....X.XXX....X.X...X...X..
..X..X..X......X...X.......X...X....XXXX.....X...XXXX.XX.......XXX....XXX........
.X..XX...........XXX..X........XXXXX.....X.X........X..X.XX.......XX.......X.....
.X....XX......XX...XX.....X.....XXXX....XX...XX...X....X.X......X....XX.......XXX
...XX.XXXX....X..X...........XX..XXXXXX.....XX..XX.......X......X..XX...X.X...XXX
...........X....XXXXXX...XXX.X...X..XXX..X..XX.....XXXX.....X.XXX..XX..XX.....XXX
.....XX......XXX..XXX..XXXXX...XX...XXX..X.XX...X..XXXX...X.X........X.X......XXX
XX........X.......XXX...X.....XXX.X..XXX......X.X.....X...X...X...XX.X.X......XXX
...XXX....XX..X...X..XX.....X.....XX.XXX..X.......X.....XXXX....X.XX.....XX..XXXX
..XX......XX..X...X......XX.......X..X....X....X.XX.XX.......X.....XX....XX...XXX
X.XX.......X....X.........X.......X....XX....X...XX.XX......XXXX.X.XXXX...X.X....
X......X.X...XX......XXXX........X.......X....XX.....X...XX......X......X...XXXX.
XXX......XXXXX...XXX..XXXX...X.....XXX.....XX....X.X...X...XX....XX....XXX..X....
....X...X..XXX.X......X....X...XX....X..XX....X..X....XX.X.....X.XX....X....X..XX
.XXXXXX....X.......XX...X..........X....XX..X.......XX.....X.X.X..XX...X..X.XX...
.........X......XX.XXX..X.X...X.......X...XX...X........X....X.XX....X.XX.X..XXX.
X.............X..X...X........X...X.X...X....X........X.X.X.........XX.......X...
X.XXXXX..........XXX.X.....XX..X....XXX..XX.....XXX.....X...X.X.....X....X.....XX
X....X........XX...X.XX.X......X.X...XXX....XX.......X...X....X....X..XX....X..XX
XX.....XX........X.X......XXXX.....X....XX......XX.X...X...X...X...X....X........
......X.....XX.X.X.XX......X....XX....X.......X..X..XX.XX..XXX..........X.XX.XX..
.XX.XX...XX....X.X.X..X....X......XX......X...XX..X..X.X.....XXXX...XXX......X..X
.XX....X.X...X.....X.XXXXXXX..XXX....X.X....X..XX..X...X.....XXXXXX........XXX.XX
......XX...X......XX...XXXXX..XXXXX..X.....XXX..XX..X..XXXX.....XXXXXXXX.......XX
XX....X.......X....XXX...XXX............XX..X...XXX...XXXX..XX.....XX...XX....XXX
XX...XX.....X......XXX.....X.X....XX..X...X.X....X.......X.X...X.X..X.X.XX.XX....
.....XX..XX.X..XX..XXX.......X.XX..XX...X......X...X...X.X.......XX...X..X..X..X.
..X...X...X.X..XX..XXX....X....XXX...........X.X..XX.X......X...XXX..XXX....XXX..
X...X...X...XX..X.......X...XXXX.......X...X...X...X....X.X...XXXX....XXX.....X.X
.......XX..XXX....X...XXX........X.......X....XX.X....X.X..........XX.XX..XXX....
.XXX...XX....X.X.....XXXX..X.....X......X...X....XX...X..X........X...X..XXX...X.
.XXX.........X...X...X.....X.XXX..XX....X....X....X.X.XX...X...XX...X...XXXX.....
...XXXXX.XXX..X..X.X.....X.....XX....XXXXXXX...XX...X..XX....X..X..........XXXX..
....XX...XXX.....X..........X....XX.......X....XXX..XX.XX.X..XX........X...X....X
..X....XX..X...X...XX...X...X....XX.X.......X..XX...XX.....XX..X.X..XXXX.....XX..
.....XXXX....X.....X..XX....X.......X....X....XXX.X......X.......X..XXXX..XX...X.
.X....XXX.......X....X...X..X...XX...X............XXXXXX..X...XXXX..X.....XX.X.X.
...XX...X.....X...X......XXX..X....X...XX.XXXX...X...XX...X.X...X...X.XXX....X...
XX......X...........XXX..XXX....X..XX..XX......X...X....X...XXX...X...XXXXX..XX..</walls>
			</board>