<?xml version='1.0' encoding='UTF-8'?>
<board>
				<level>98</level>
				<width>37</width>
				<height>35</height>
				<walls>X.....X....XXXXX....XXX..............
..X...X.......XX.XX.....XX...XXX..XX.
......X..XX.X..X.XXX...X...X.........
...X..X...X..X.X.X...X.X.XX.....X...X
.X...X..X.XX.....X.XXX......XX....X..
.XXX.X........XX......X...XX...X...X.
..XX.....XXX........X.XXX..X..X....X.
X.....X......XXXX...X....X.XX...XX...
....XX..XXX...XXXXX.XX...X...XXXXX...
.X.....XX...X.......X....XXX.........
.....XXXX.............X....X.....XX..
X.XX.....XXX....X.......X....XXX..XXX
..XXX........X....X.......XXXXXXX....
.XXXX.X...XX...XX......XX...XX..X..X.
..XXX...XX....X....X...XX.X.....X..X.
X......XX..XX....X...X..........XX...
XX...X..X.XXXXXX......XX.............
...X..X......XX...X......X.......XX..
.X..X.XX...X....X..XXX.....X..XX..X..
....X....X.X..XX...XX...XXX...XXX...X
X...XX.....XXXX..X.XX.X.....X.XXX...X
X...XX..X...XX..X..X.....X..X.X......
..X..XX...X....XX....X.X.X..X......X.
.....XXXX.....X......X.......X...X...
...X...XX..XX...XX......XXXX..XX.....
.X...X..X..X...X...XX....XXXX........
.X..XXX......X........XX.......X.....
.XX......XX....XX.XX....XXXXXX...XX..
.XX..X...X..X.....XX.X........X..X...
..X..X..XX.X..X.XX.....X......XXXX...
X..X..X....X.X..XX..X.....XXXXXXX..XX
...X..X........X....X.X.X.......X....
......X...X.X.....X...X..X...XX...X..
XXX...XX....X.X.X.XX.....X.X..XXXX..X
XXXXX....X....X...XXXX.....XX......XX</walls>
			</board>