<?xml version='1.0' encoding='UTF-8'?>
<board>
				<level>66</level>
				<width>25</width>
				<height>25</height>
				<walls>XXX..X.....XX....X....XXX
XXX..X.X......X..X.X..XXX
XXX....X.XX.....XX.X.XXXX
XXX......XX..X...X.......
..XXXXX...X....X.XX.X....
...XXX..X....X......X.X..
.X.....XX..X....XX..X.XXX
.X......X....XX.....X....
...XXXX...X....XX...XX...
..XXX...XXX......XX....XX
....X.X.X.....XX.X.......
......X...X........XXXX..
...X..............XXXXX.X
.....X.....XX.....XX....X
XXX..X.X......X.X....XXXX
...XXX.....X..X...X......
.X.XX...X..X...X....X....
......X...X..X...X.....XX
X.X.......X........X.X...
X......X..XXX...X....XXX.
...XX.....X...XXX.X......
......X...X....X..XXXXX..
XXXX..XXXX...X...XXXXX...
XX....XXX..X.....XXXX..X.
XX....XXX........XXXX....</walls>
			</board>