<?xml version='1.0' encoding='UTF-8'?>
<board>
				<level>256</level>
				<width>89</width>
				<height>88</height>
				<walls>...X........XXX.....X....X..XXXXX...XX......XXXXX.......XX....XX..XX.....X..X.......XX...
...X.XXX..X.......X...XX....X.....X.X..XXXX..X......XXX....XX.X...X..XXX....X....XX..X...
X..X...X................X...X.....X...X...XX...X.X....XXX.....X.X.X.XX....X..XX..XXX..X..
...XXX...X.......X...X....X..X........X.X......X...X....X...X...X.X.X..XX....X..X..XX....
.X...XX.....XX.....X...X...X...X........X..XX........X..XXX.....X.X...XX...X...XX....X...
.XXX.X..X.X....XX..XX....X..........XX...X....X.XXXX...XXX..XX..X.XXX....X.....X..XX.XXX.
...X...XX..X...XX.....X.....XX.........X...X..X.X......XXX..XX..X.X...X..XX....X.XXX..X..
....X......X.XX...XX......X......X...X.......XX...X....XXX......X.X.XXX..XXXX..X.XXXX...X
..X...X......XX.XX...X......X.X....XX...XXXX.X.....XX..XX..X......X..XXXXXXX.....X..X..XX
..X.........XXX..X..XX...X....X.X...X.X..XXX...XXX..X..XX....XXX...X.........XXX....X..XX
X......XXXX..X...XX..X.X...X......X......XXXX....XX....X..X........XX....XX.........X....
X.XX.......X.X....XX.X.X.....X....XX..........XX.....X.X....X.......X..X.XX.XXX.....X....
X..XXXXXXX........XX...X.......X...X.....XXX.........X.X.XX...XXXXX..X.X....XX..X...XX...
XX.....X....XX...XXXXXX.....X....X...X...XXX.X.......X...XXX....XXXX.........X......XX.X.
XXX......XXXX..X.X....X.X.X...X...X....XX..X.....X...X..X....X...X....X.XXXX.X...XX......
XX..X.XXXX....XX...XX...X....XXXX......XX.....XX...X.X.....XX..X...XX...XX...X.XXXX.X.X..
...XX......X....X......X...X...X...X......X........X.X...X.XX.XXXX.....XX..XXX.X......X..
.XX...X...XX......XXX..X.XXX.....X....X.......X......XXXXX....XXXX.X......XX...X...X.....
....X...X.X....X......XX...X....XX.XX......X......X...XXXXX..XX....XXXXX...X....X..XXX...
..XXXXX.....X.....XXXXX....X..XX...X...X...X.X.XX...X........XX...XXXX...X..XXX...XXXX...
X..XX...XX....X.X.......X...XX...XX..X...X...X.............X.XX.....XX.XXXX....X..XXX..X.
...X....XXXX..X....XX...X.X..X..XXX.............XX.X....XX.X...........XXX...X....XXX....
.X.X.X..X..X.....X....X.X.XX.XX...XXXXX...XX..X....X..X.......XX...X...X...X......XXX...X
.X.....XX....X.XXX.X..X...XX..X........XX.....X..XXXX.......X....XX..X...XXXX......XX....
....X...X.X..X.....X..XXXX....X..X........X...XX..XXXX....XX........XXXXX...X.X....XX....
..X...X...X.XXX...XXXXXXX..XX..XX.......X...X.....X.....X....X...X..XX....X...X.X.....XXX
XXX....XXXX..XX.X......XX...X..XX.X.....XXX....XX...X.X...X....X.X...X.X..........X.XX..X
XXX..X...XXX..X....X......X....X......XXXXXX...X......XX..X...XX...X...X...XXX.X..X.....X
...X........X....XXX..XX..XX...X.X......XX...XXX.....XX..X..XX....XXXXXX...XXX.X.X....X..
...X..X.X...X..XX..XX.X..XXXXX.X.XXXXXX.X....XX...XX....X..X...XX....XXX.....X.....XX....
..XX..X.X.XXX..XX...X...XXXXX..X.X....X...X...X.X....X..X..........X..XX..X..XX......XXXX
....XXX......XXXX.X......XXXX............X..X.X....X.......XX.X.......XX....XXX....X..XXX
.....X...XXX....X.X..X.....X....X...XX.X.X.......XXX..XXX..X..X...X.............XX....XXX
...X...X......X.X..X....X....XXX.......X.....X....XX..X...XX...X..XXXXX.X....XXXXX..XX...
.XXX.......XX....X....X...X...XX.X.X......XXX..XX..XXX....X..X...XXXXX..X.....XXX....X...
..XX.XX....XXX.X....X....XXXX......X.XX.......XXXX.X...X..X.......XXXX........X...XX.XX..
X.....XXX...XX.X.......X........X....X...XXX.....X.X.XXX....X.....XX.......X.....XXX.....
....X.....X....X...X.X............X..X.X.XXX.X.....X.......XX....XX..XXXXX...X.X...XXX...
.....X..........X..X....X.....XX..X....X...X....X...X......XX..X....XX.......X.XX..XX....
XXXX.......XXXX.X.X...X...XXX..X......XXXX....X.XXX.X.XX....XX....X.....X....X....XXX....
XXXXX...X..X....X...XX.....XXX...XX.........XXX...X.........XX..X...X.X.XXX..XXX.........
XXXXX...X.XX.XXXX......XXX...X......XX....X..XX.....XX.X......X...XXX...XXXXXXX..X...XXXX
XXXX....X....XX.....X.....XX......XX...X.....X...XX..X...XXXX..XX......XXXX..XX.XX.X..XXX
XXX..X.....X.....X....X...X...XXX....XX..X.....X..XX........XX..X..XXX....X..XX.X.....XXX
XXX.XX..XX...X...X.X....XXX.XXX.........X....XX...XX..XXX...X...X....XX...X...X...X.....X
..X...X..XX...XX...XXX...X..X.....XXXX..X.X..XX.XX....X...XXX........X..XX..X...XX......X
......XX....X.....XXXX.X...X..XX..X..X....X.XX..XX........X......X.....XXX.XXXX.X..XX....
..........X..XX........XX....XXXXXX....XX......X.....X....X.X......XX..X...X......X...XX.
.....XX.X....X..XXX....XX.........X...XX..........X....X..X....XX........XX..X...........
.X...XX.X.XX.X.XXXX.XX.XXX....XX....X....X......X.XXX..X.....X....X.....XXX.XX..XX...X...
.X.XXXX.X....X..X...XX......XX...X......X..X........X...XX.XXXX...X.X...X......X..XX...X.
......X....XXXX...XX...XXXX....XX..X.X..X......X.XX...X....XX...X.....X........X...XX..X.
..X.X....X..XXX..XX..X.....XX..XX..X...X....X..X.....X...XXX....XX...XX..X....X..X..XXX..
....X..X.XX.XXX..X..XX..XX...XXXX.....X..X....X....X...X..X..X.....X...X...X....XXX...X.X
...XX....X..X......XXX..XXXX......XXX...XX...X..XX.XX...X...XX...X...X..XX.X.......XX...X
...XX.X....XX........X.....X..X....X...XXXXX.X........X.XX.......X......X....XXXXX.....XX
........X...X........X.....XXXX..X...X..X......X..X.XXX....X.....X..XXXXX.X...XXX....XX..
..XX.XX...X.......XXXXX....XXXXX....XXX...X.XX.X....XXXXXX...X...XX.........X.....X......
.....X.........XX.......XX...XXXX...XXXX....XX.X.....XXXX......X....X....X.....XX...XX...
...X...X...XXXX.......XXX....X....XXX..X...XX.....XX.X....X.XX...X..X.X......X.....XX..X.
...X..X..X..........X.....X..X.X....X......XX.X.X....X.X....XX........X.X......X.X.XX..X.
.XXXX.X....X...X..X....X.....X...X....X.........X..........X....XX.............X.X.......
..XXX...X....X...X...XX..X...XX....X.......XXX......XXX....X.XX..X.XXX...XX......XXX....X
X.XXXX....X...XX...X.X..XX...XX.X.X..X.X.........XX..X...X...XXX...XXX........X.XX....X..
X....X.X......XX..XX...XXXXX......X.XX....X.......XX...X.....XX...XX...XXX.XX.X.XX.XX....
XXXX.....X....X.......XX.......X........X.......X..XXXXXXX...X..X....X.....XX.X....X.....
.....XX.....X...X..X.....XXXX..XXX.X....X..XXXX.XX.X..X..X..X..XXXXX....XXXX....X..X.XXXX
..........X.X..XXXX..X........X..X...XX.....X......X.....XX...XX...X..X.X....X.....X.X...
....X.XXXX.....XXX..XX....XX..X...X..XXXXXX............X.....X...X.XX...X.X..X...X...X.X.
.X....X....X.X...X.X...X....XX..X.X........X......X........X.....X.X......X..X......X..X.
.X.X......XX..XX...X.XXX.X...X......XXX........X..X...X....XXXX..X.....X..X..XXXX.XXX.X..
.X........XXX.....XX.XXX.X.X...X...X....X........X....X...XXX.......X....X..XX..X.......X
....XXX.........X....X.....X.....X.....X..XXXXX....X...XX.XXX.XXX.....X..X...X....XXXX...
X....XX..XX.......X.....X.....XX....X..X....XXX...X..X.XX.XXX.........X..X.X...XX...X....
..XX.XXXXX..XX.X..X...X.....X.....X...XX.X......X...XX.XX.XX.....X....X....X..X.......XXX
.....X.....XXX...XXX.....XX.....X....XX..X.X.........X....X..X.....X....XXXX.......X.....
........X......XX....X.......XX....X..X........X...X....XXX....XXXXXXX.XXX.....X.X.......
XXXXX.X.XXX.XX.XX.X........X.......XX...X...XX.XXX....X..X....XXXX..XX......X....X....X..
...XX.X..X..X..X......XX.....X.....X......X....XXXX....X.X.XX....X..X...X...X.X.....XX...
......XX...XX.XX.X.X......X......XXX.X...XX.X..X..X....X...XX....X....X.XXX.....XXX....X.
..X....X..XX..X....X.XX.X...XX....XX...X......XX....XXX...X.....XX.XX...XX...X.......XXX.
..XXXX.X..XX....X....X..X......XX.XX..XX..XX..X..X......X....X...X.....XXX.X.X...XX..X...
..XXX..X..........X..X......X.....XXXX..X..X..X.....XX.....X.X.X.....X..X..X...X....X..XX
...XX....X........XXX....X......XX......XX.X......X.XX.........X..XXXXX...XX..XX...XX...X
.X.......X...X.....XX.XXXX.X.XXX.....XX......XXXXXX....XXXX.....X.....X..X....XXXX....X.X
.X..XX...X....XX.X..X..XXX...X...XX..X...XX...X..XX..X...XXXXXX....XX.......XX......X...X
.X..X..XXX..X.XX..X..X...X........X....X....X....XXXXX....XX...X.X....XXXXX..X....X......
......XXXX..X.....XX.....X......X...XXXX..X......XXXXX..X....X...X..X........X..X........</walls>
			</board>