<?xml version='1.0' encoding='UTF-8'?>
<board>
				<level>52</level>
				<width>21</width>
				<height>20</height>
				<walls>.....XX...X....XXX...
...X....X.X......X.X.
XX...X..X.....XX...X.
XXX......X.....XXX...
....X........X.....XX
...XX...X.XXXX..X..XX
....X.X.X...XX..XXXXX
..X.X.......XX.......
XXX....X.......XXX...
.....X....XX.......XX
...X....X.....XXX...X
......X....X..X...X..
..X......XX..X..XXXX.
.....X......XX.XXXXX.
...X.X...X.....XXXXX.
XXXX...X...X.XXX.....
......XXXX.X..XX...XX
...XX..X......XX...XX
.....X....X....X.....
..XX....X......X..X..</walls>
			</board>