<?xml version='1.0' encoding='UTF-8'?>
<board>
				<level>134</level>
				<width>49</width>
				<height>47</height>
				<walls>XX...XX...X....X...XX....XX......X..X.....XXXXX..
X..X....X...X....X..X..X.......X....X...X.X......
X...XX.....XX.X.XXX..X.....X....XXX..X....X.XXXX.
..X....X...XX.....XX....XX....X....X...X....XXX..
....X....XXXX..X...XXXX..X.XX....X.XX........XX.X
.XX............XXX.....X...X...XX..XXXX.XXXX....X
..XX........XX.......X.......X....XXX...XX....X..
X.......XX..X.....XX..X........X....X.......XX...
..X.X......X..X.....X.X...XXX..X.XX....XXXX....X.
....X....XXX.....X....XXX......X.....X...X.......
.X.............X...X...X...X...XXXXX.X.....X....X
.X...X............X..X...X...XXX..X..X..X....XX..
..X.............X...X...............XX....X....X.
X...X.....XXXX..XXXX..XX..XXXX..........XX..XX.X.
XXXXXXXXX......XXXX..XXX..X....X......X....XXX...
X.......X...X....XX.......X.X....XXX...X...X..X..
..X.....XX....X....XXXXXX....XX......X...X....X..
.X..XX..X..X....X..XXXX....X......X..XX..XXXX....
...X....X.X..X....XXXXX.XXX...XXX.X..XX..XX......
......X...X....X......X.....X.XXX.X..X....X.XXXXX
.XX.X.XX..XXX...XX.XX....X..X.X........X....X..XX
.X..X....XXX..X.X..X........X....X.XXX...X.....XX
...XX..X.XXX.XX...XX.X..X...XX.X...XXX..X...XX...
XXXXXX.....X.....XXX.X.......X.X....XXX...X......
............XX....XX...XXXXX.X...XX......XX..XXXX
.....XX...X.....X..X..XX.....XX.....XX.X..X..X...
..XX....X....XX....X..X.....X...XXX.XX....XX...X.
X...X...X..X.....XX.....X.X.X....XX.....X..X..X..
X.X.....X..XXX.XX...XX..X........X...XX..X..X...X
..X..X..X...XX...........X.XX......X.XXX.XX....XX
.XX....X..X....X...X...X...X..XXX..X..XX...X...XX
..X.X....XX..X.....X.X....XX.X..X.....XXXX.....XX
X...X.X...X..XXXXX...XX...X..X....X....X........X
XX..X.....XX..XX...XXXXXX...X..XX......X...XXXX.X
X...X..X...X..X....XX......X..XXX............XX.X
..X.X....X....X.X.....X......X....XXXXX.......X..
.XX...X..XX...X.X.XX....X...XX...XX....XX...X....
.....XX....XX...X.XX.X..XXX...X.....X..X..X....XX
X....X..........X.......XX....X.X.....X..XX.....X
X.X..X.X....XXX...X...X....X.......X..X.........X
X.XXXX....XXXXXXX.....X............X.....X...XX..
X...X...X..........X....XXX.X.....XX...X...X.....
XXX.X...XXX....X...X.X....X........X...X.....X...
....X..XX...XX...X...X.XX...XX...X...XXX..XX.....
.X..X...X....X......XX..X......X...........XXXXXX
..XX..X....X.X....X.X...X...............XX..XXXXX
X....XX..X...X..XXX...XXX.........XXXXX.....XXXXX</walls>
			</board>