<?xml version='1.0' encoding='UTF-8'?>
<board>
				<level>136</level>
				<width>49</width>
				<height>48</height>
				<walls>......X..XX...X..XXX..XX....XXXXX..XX..XXXX......
.XXXX.X.....X.X....X.....XX.....X..XX..X....X....
........X.....X......XX...X..XX.X...X....X....X..
.....X.XX...XXX...X...X.X.X.......X...X..X.XXXXXX
.XX..X...X....X.....X.....X.XX.....X.....X.......
....X....X.X.....X....XX....X....X.....X.XX..X...
XX..X........X.....X....XX....XX....XX.X.XX..X...
XX..X.....X.....X.XX.X...XXX.XXXX...X....X...X...
XX....X.......X...X....X...X..XXX.X.X.X....X.....
...X.....X.X.....XX.X.XX...XX...X.X.X...X....XX..
.....X.X...X...X......XX........X.X.......X..XXXX
XXX....X..XXXX.....XXXXX..........XX.....XX.XXXXX
X...X.....XXXX..XXXX...X......XXXXXXXX...........
X.X.XXX.XXXX....X....X.X....X...X........X.......
X.....X..XX...X...X..X.X..X.......XX..XX...X...XX
...X..XX....X.....X..X..XXX....XX.....XX.....X...
.....XX........X..X.....X....X......X.....X...X..
XXX...X.XXXXXX.X....X.X....X...X........X...X.X.X
X...X...XX.......XX.X....X..X..X...X....XX..X....
X.............X.......XX..X..XXXXX.....XX......X.
..XX...XX...X......X......XX......X.X..XX........
..X..X......XXX....X.X.X......XXX...X.XXX...XXX..
....XX..XXXXX...XX.....X....X......XX.X...X......
.X...XX.........X.....XX..X....X.X......XXXX.....
...X.....XX..X....XXXX....XX...X...X.X...XXX..X..
X..XXX.X.XX...XX...X....X........XXX...X.XXXX...X
XXXXXX.X....X...XX...XX.....X............X..XXX.X
XXX..X..X...X.......XX...XX.XXX.............X...X
XXX.....X.X.X....X.....X..X.XXX.............X.XXX
..X.......X....X...X.X....X..X..XX....X.....X....
...XXXXX.....X....XX......XX...X...XX.....X..X...
.X.X.....X.X....X.X...X...XXX........X.XX..X...XX
.X...XX....X........X..XX...X.X...X....XXX.....XX
..XX....X........XXXXX......X..XX...X....XX....XX
X....X....X.X.....X.....X....X.X...XXXXX.X..X..XX
..X....X....X.XXX.....X....X.....X.XX..X...XX..XX
....X....X......XX.......X....X.XX..........X..XX
...XX.X.XX.X.XX....X.X......X...XXX.....XXX.X..XX
.XXXX...X..X.....X.X...XX.X..XXX..X.X.XX.........
..XXX.....XXXX...X.....XX.........X.X.XX.X...XXX.
X.XX..XX...X.....X.....XX..X..XXX...X....XXX..X..
X....X...X....XX...X......XX.......XXXXXXXXXX...X
X.........XXX..X.....XXX..X..X.............X..XXX
....X...X....X...XX......X..XX.XX........X.X.....
.X....X.........XXX......X.....XX....XXX.....X...
...XX....X..X.X.....X..XX...X.....X.....X.......X
....X..X.X....X..XX.X...X.X...XXX...XXX.XXXXX.X..
....X..X...XXXX..XX...X...XXXXXXX..XXXX.......X..</walls>
			</board>