<?xml version='1.0' encoding='UTF-8'?>
<board>
				<level>91</level>
				<width>34</width>
				<height>33</height>
				<walls>XX..XX...X..............XX....XX..
....XX.X.....X....X.....XX....XX..
..X............XX...X...XXX...X...
X....XX.XX......XX....X...X.X...X.
XX......XX......XX.X....X...XXXXX.
X..XX....XXX.....X.X....XX..XXX...
X.XX...X.XXX..XX.X...X......X...XX
..X..X...X..X..X..XX...X..X.X....X
.XX...X.....XX.XX...X.....X.XXXX..
.XXXX...XXX..X..XXX...XXX...XXX...
.....XXXXXXX..X.....XXXXXX..XX..XX
XX...X........XX.........XXXX..X..
...XXX.....X.....X...X......X.....
.XX..X...X....X..XXX....X.....X...
.XX....X....X.X..X....X.X..X....X.
.X..XX....XX.......X....X....X..X.
...X...XX....X.XXX.....XX......XX.
XXX....X.....X......XX.XX...X.....
....X..X.XXX......X.......X...XX..
...X...X...X..XXX.....X....X......
XX.X.X.XXX.X..X....XXXX.XX.X...XX.
XX.X.....X.XX....X.XX....X..XX....
...........X...X...X...X..X.....XX
..X.....XX...X..X....X..X....XX..X
X.....X..X..X...X....XX..XX..XXX.X
XXX......XX.X....X...X...X..X....X
....XX....X.XXXX.....X.....XX.....
...X...XX...XXX..XX........X......
X..X...X......X...X...X....X.XXXXX
..XXX..X........X.XXX.....XX...X..
.XXX...XX.XX......XX...XX.X..X....
...X...XX......X...X......X...X...
XX.....XXXXXXX...X..........X.....</walls>
			</board>