<?xml version='1.0' encoding='UTF-8'?>
<board>
				<level>138</level>
				<width>49</width>
				<height>49</height>
				<walls>.........X...........XX..........XXXXXXX....XXXXX
.XX......X..XX...XXX.XX....X..XX...XX..X.XX..XXX.
....X....XX..X.X.....XXXX..X...X....X....XXX.....
..X....X.XXX...XXXX..X....X..X....X...X...XX..XXX
XXX..X.X.XXXX........X.XXXX..XX.XX...XX.X........
.....X.X......X....X......X...X....X..X.XXX..XXX.
...X.....XXX....X.....XX....X..XX.....X...X..X...
.....XX......X....X......X...X....X...XX....XX.XX
..........X....X.............X..XXX.X....X.....XX
....X...XXX.X..X...XXX....X...X..XX...X..X...XXXX
..X...X.....X....X......X...X....XX...XXXX......X
XX.........X..X..XXXX.X.XX..XXXX..X.......XXXXX.X
...X.........XX.XX..X...X....X....X..X......X...X
.XXX....XXX...X..X.....XX......XXXXXXX.X.X....X..
.X...X....XXX.XX...X...XX...X....XX..X.X.X.X.....
...X...XX.....X.......XX..X......X...X.X.X.XXX...
..XX..XXXX....X.XXX.X.XX.XX..X.....X.....X...X...
XXXX.......XX.......X....X......X..XXXX...X..X...
XXX...........XX.....X.....XX.X.XXXXXXXXX...X....
....X.X...XX.....XXX...XX..XX............X....XXX
.X....X.X....X...XX...X....X...XXX..X......X.XX..
.XXX.X..X...XX..XX..X.X......XX.....X.XXX....X...
.XXX...XX.X..X.....XX.X...X......XX...XX..XX...X.
....X.....XX...X........X......X.X...XXX.......X.
X...X......X.....XXX.X.....X.......X.X....X....X.
X.XX.......X.XX..XX..X.X......X.X......XX.XXX..X.
X.X..XXXXXXX..X.....X..X....X.X...X.X.......XXXX.
X.X....XXXXXX.....X...XX.XX......X..X...XX...XX..
.....X.........X....XXXX.X.....X.X...X.....X....X
.X.X..X...XX...X.X.......X.X...X.XXX...X.........
...XX...X.X..XX....X....X..XXX....XX..XX....XXXX.
..X....X....X...X.XX..X...XXX...X..X.....X..XX...
.........X......X...X....XXXX....X.X...X...XX..XX
...X..X......X....X....X....XXXX.X...X...XXXX...X
....XXX...XX.XXX....XX.XXXX......X...........XX..
..X.X...X....XXX.....X...............XX...X..X...
X.....X...X..XXX...X..XX..XX....X.XX.XX.X...X..XX
..XX.XX.XX...XXX...XX.XX.....X....X.....X.XXX.XXX
.XXX..X.XX...XXX...XX....XXX...X....X......X..X..
.X....X.X...XXXX...XXX.............X.....X...X...
...X....X...XXX..XXX........X...XX.X.X....XXX..X.
XX.....XX..XXX..XX....X.......X..X...X..X..X..X..
....XX.XX....X.....XX....X.....X......X.XX...X..X
..X....XX.......X......X..XX.X...XXXX...X..XXX...
X.....XXX.....X..XX.XX..X....XXX..XX....X......X.
...XX...X.....XX....X...X..X...XX....X....XXXX...
.X..XXX.X.............X.X..X.X.XX......X........X
..X...X.X....XX....X..X.X....X..X.XXX...XXX...X..
X.....X...XX....XX......X.......X.....X.....X....</walls>
			</board>