<?xml version='1.0' encoding='UTF-8'?>
<board>
				<level>165</level>
				<width>58</width>
				<height>58</height>
				<walls>...X..X......X......X..XX..X.....X....X....X...X..XXXX....
...X....XXXX...XX...X...X..X.XXX...XX...X....X.X.......XX.
..XX...XX.....X...XX..X.X....XXX..X....XX.X......X....XXX.
.....X......X....XXX....X.X..........X....XXX...XX.XX.....
.......X.......X....XX....X......XXX...X....X....X.XXXXXXX
XXXXX....X.X......X.X..X...XX....XX...X..XX......X........
X.....X..X......X.....X..X....X.....X...XXXX..XXXXXX......
X.......XXX.X...X..X....X..X..X...X..X........X....X.....X
...XXX...X..X.X..X..XX..X....XXXX....X...XXXX...XX....XX..
.X.X...X...X.....XX.....X.X.......XX..XX.......XXXX.X..XX.
.X...XXX..XX.X.XX.......X...X.X.......XXXX..XX....X....X..
.XXXX..X..XX.X.XX.XXXXXXXX....X.XX..........XX..X.XXXX...X
..XX...........X........X..XXXX..XXXXX..X...XX....XXXXX..X
X....X..XX..X....X.XX.....XXXXXX....XX....X....X....XXXXXX
.....X..XX......X..X..........XX....X..X..X...X..XX.......
.XXX.X.....X....X.XX.X..XXXXX.XX...XX.XX.XX.X...X....X....
.....X...XXX..XXX.XX...XXXX...XX...X..XX..X..........X.XXX
X...XX....XXX...X...X....XX....X...X...XX........X.XXX....
..X...XXX..XX.......X.X........X.......XXX.........XXXX...
...........XX..X........XXX.......X.........XXXXX.......XX
..XX.X....XXXXX..X...X.X..........X.....X.X.......X...XXXX
..X..X....XX....XX.X.X...X.XX...X..XXXX.X.XX........X.....
....XXX...XX.X...X.X.....X..X.X...........X....X.....X....
.XX..XX.X.X....X...X.....XX......X..XXXX....X....XXX.....X
..........X.X.XX..XX....X..X...X.X......X..X..XX.XX...XX..
XXXX...X......X....X..X.X...XX.X...XXX..X....XXX.XX.XXXXX.
..X..X...X...XX.XX........X..X.XX......XX...XXXX....XX..X.
....XXX..XXX..X.X....X...XXX.X..X..XX..XX....X..XX..X...X.
........XXXXX...X.X..X....XX....XX....XX...X........X.X.X.
..XXXX.....X......X.X.....XX..XXXX..X..X.X....X...X...X...
.....X...X.X..........XX...XXXXXXXXXXX...XX.....X.XX.....X
...X...XXX.X...XXX.......X...X............X..X.......X.X..
.XX..........X....XXXXX..XXX.......XX...X..X.....XXX...XX.
.XX.XXX...X.XXXXX....X........X.......X....XX......X......
....X...X...X......X.X............X.X....XXXX....X.X......
XX..X......XX...XX....XXXXXXXX....X....XXXXXXXX....X..X...
....XXXX.X......XXX.X......XXX.......X..XXX.....X.XXX.....
....XXXX.....X...X..X......XXX...X...XX......XXXX...X.XX..
XXXXXX...XX....X...X......X..X......XX.....X......X...XX..
XX...X.X....XXX......X.XX.X...XXX.X....XX..XXX....XX......
...X...X..X.....XXX....X....X.XX..XX....X..X...X..X..X.XX.
....XX......XX..XXX......X.X.....XXX.XX....X.....XX..X....
..X....XXX..XX....X...X....X.X.....X...XXX.......XX..XX..X
..X...XXX......XX...X...X.......XX..XX.....XX....XX..XX...
..X.X...X........XX..XX...X...X.....XX........X...X...X.X.
....X......XX..X.....XX..X..X....XX..X....X.X...X...X...X.
...XX....X..X....X...XXX.X.....X.....X..X...X......XXXX...
...XX....XX...X..XXX.....XXXXX...XXX..X....XX....XXX....XX
.......XX..XX...XXX......XXXX....X....X.XX...X...XX..X....
...X.......X........X.......X....X.XXXX.X....X.X....X..X..
.X...XXXXX...X.X......X.X..........XXXX...X....XXX..X....X
..XX......X....X.....XX....X..XXX...XXXX....X..X.....X..XX
X..X..XXX.....XX..X..XXXXX....X...X..X........X..XXX.X....
XX......X......X..X..XXXX..XX.....XX....X..X..X........X..
..X...X.X....X.......XX...X....X.....XX....X.XXXXXX.X....X
....X...XXXX.......XXX......X......X.......X........X.X..X
.....X...XXX..XXXX.....X.XX...X....X..X....XXX...XXX.....X
XXXX...X...........XX..X....XXXXXX......XX.....X.....X...X</walls>
			</board>