<?xml version='1.0' encoding='UTF-8'?>
<board>
				<level>174</level>
				<width>61</width>
				<height>61</height>
				<walls>.......X...XX..X.......XXX...X...X....XX..XXXX..X.....XX....X
....XX...X.X...X.....X.....X...X.X....X...X.....X.....X..XX.X
..X.....X..X.X.XXXX..XXXX..XX..X..X...X.X...X...XX....X.XXX..
.....X..X......X....XXXX..........X.X...XX..X...XX.XX...XX...
...X...X......X..X....X..X..X...XX..XX..XXXX....XX.X....XX.XX
X......X.X......XX....X.....X.X....X......XX.........XX.XX.XX
X.XXX..X.X...X..X..X.....XX.....X....X......XXXXXXX...X....XX
X.....X..XXX.XXXX....X.......X....X.XX...X......XXXXX..X....X
XXXX..X...XX.X....XX....X.XX.X.X....XX...X...XX........X.XX..
.....XXXX......XXXX...X...XX...X.X...X.....XXX...XXX.......X.
....XXXX....XXX.....X.XXX..XX..X..XX.X....XX...X.....XX......
..X....X.........X..X..XX..X...XX.XX.X..XX...XXXXXX.........X
...XXX.....XXX.X.....X.....X.X........X......XX...X...X...XXX
.X..XXX......X....XX.....X...X...X....X.X....XX.X.....X.X...X
.XX.XXX.X.........XXX........X.X.XXXXXX.XXX..XX.........XXX.X
....X.......X.......X..XX........X..........XX......XX..XX..X
X.....XX.X........X.XX.X...XX.X....XXX.XXXX.X..X....XX..XX...
..XX..X..X.X.X......X....X.X..XXX..XXX..X.....XX.X..XX..X....
.X...XX....X.X...X....X......XXXX....XX....X.....X..X..XX.XXX
...X....X..X..XX.....X....X.......XX.....X....X....XX...X..XX
XXXXXXX.X...X...X......XXXX.XXX...XX..XX....X.X.X.....X.XX...
..........X...X....XX...XXX..X..X.X...X.......X.X.X.XXX....X.
......XX.X.......X......XXXX....X.X.X...X..X....X...XXX..X...
XX....XX...X........XX.....XXX..X...XX..X....X.......XX..XX..
...X.........XX..XX.....XX.X...X...X......X....X..XX.XXXX....
..XX...X......X.......X.XX...........X...XX.X..XXXXX...XX....
X....X....X.X...XXX.......X...X...X....X......XX..X....X.....
X..X....X...X..XX...........X............X.X..XX....XXXX.X...
XXXX..XX...XX..X...X..........XX...X.......X.XXX...XXXX......
......X..X.....X.X...X.....X.....X...XX......XX..XXX....X....
....X...X..X.......XX....XX..X.......X.......XX......X..XXXX.
X......XX.....XXX...X.XXXX..X.....X....XXXXX..X.....XXXX..X..
.....X.XX.XX..XX..X.X.X....X..XX....X...XXXXX...X.........X.X
.X...X....X..XXX.XX...X.X....X...X...XX...XXXX.....X......X.X
...X........XXXX.XX..X....XX....X..X......X......X...X......X
.....XXXXX.....X..XX...X......X...XXXXX.......X........X.....
..X..X..X..XXX..X..X.XXXX...X........XX....X..X.X.......XXXX.
....XX....XXXXX.XX.....XX.X...XXXXXX.XXX...X..X...XXX.X.XXXX.
.X.....XX...........XX..X.X....XXXXX...X.X....XXX.....X......
.X..........XX...X...XX...X..X.....XXX........XXXX....XXX...X
.X...XXX.XX....X...X..X..XX...X....XX..XX.X....XXX.XX.....X..
...X...X.XXXXX.....XX..XXXX...X....XX.....X..X............XX.
..XX...X...............XXXXX...X...X..XXXXXX........X.....XX.
...X....X....XXXXXX..........X.......XX..XXXXX....X...XX..X..
.X....X...XX.XX...X.........X...X........X...X.XX.....X...X.X
.XX...XX........X...XX....X...X...XXXX...X.X...X......X.X.X..
....XX...XX......XX.....X.........XX.....X...XX..XXX..X......
..X.....XXXXXXXX.XX.X.X...XX...X..XX.....XX..XX......XXXXX.XX
....X.X...X......X..X..X.....X.X...XXXXX....XX...XX..X..X..XX
...XX..XX...X..XXX.XXX...X.XXX...X..XXXXXX..XX.X........X.XXX
XX.....XXX.....X...XX....X...XX...X.....XXXXX..X..XXX...X.X..
X.......XX...X.....X..XX.....X..X....XX..XX...XXX.........X..
X.XXXXX.......XXX....XXX.......XX..X...X....XX..X..XXX.......
..XXXX..X...X.....X....X.XXXX...X...XX..XX...X..XX....XXXX...
.X..XX....XXXX......XX...XXX..X...X...X....X....XXXXX....XXX.
.X...X...XXX...X.......XXXX..XX..XXX.......XXXX....XXX.....X.
...X...X......XX...X......X...X...X..X.....XX......X....XX.X.
..XX..XX....X.XXXX....X.X...X.....X.X.....XXX........XX.XX.X.
...X....X...X.XX....X...X......XX.....X...X....XXXX..X..XX...
.X....X...X....X.......XX..........X.....XX.XX.XXX...X...X..X
....X........X.......XXXX........X.....X....XX.....X.....X..X</walls>
			</board>