<?xml version='1.0' encoding='UTF-8'?>
<board>
				<level>110</level>
				<width>41</width>
				<height>39</height>
				<walls>XX......XX....X....XXX..........X...X....
......X....X..X.X......X........X.X.X.XX.
..X...X..XXX.X..X.X...XX........X.X...XX.
X.X...X..XX....X..X....X......X...XX.....
....X..X....X....XX..X...X......XXX....XX
.X.....X.X...XX........X...X......X.X....
.XXXXX...X.X..X...XXX....XXX........X....
.....XX....XX...XXXX..X.X....X...XXXXXX..
XX...X....X....X.....XX...X....XXX..XX...
...XXX.......X...XX..XXX....X...X...X..X.
.XX.......XX...XX...X......X..X...X...XX.
....X.............X...X.XX.X......XX.....
XX..X.XX...X.....XXX..X..X.X.XXX.....X...
XX..X..XXX...XXX.X....XX...X..X..X.....X.
....XX....X..XXX.X.X..X.....X...XXXXX....
.XX.XXX..........X...X..X.........X...X..
.X..XX..XX......XXXXXX.XX.XX.XX...X.XXX..
.X...X.XX..XXX..XXXX...XX..X.XX.XXX.XXX..
...X...XX......XXXXX....XX.X......X..X...
XX.XX..X..XX...XXX..XXX..X..XX.XX..X...X.
......XX.....X.XXX..X....XX....XXX....X..
..X.X..X....X....X....X..XX..XXX....X.X.X
X...XX.X......X....XX....XXX............X
.............XX...X...XX.X.........X.X...
.XXXX...XXXX....XX....X..X..X........X.X.
.XX...XXXXXXXX...X.X....X...X.X........X.
....X..XX....X.X.....X....X...XXX..XXXXX.
..X....X..XX....X.....XXXXXXXXXXXXXXXX...
....XX...XXXX.X.X...X............XXXX..XX
....XXX..XXX..X...X....XXXX.........X...X
X..........X.........XX.........X.X.....X
..XX.XXXX....X.....X....XX...X....X..XXXX
.XX..X....X......X...X..X..XXX.X......X..
..X....X....XXX.......XXX..........XX....
X.XXX....X...X..X...X...XX....X.X........
X...XXX....X...XX....X..X..X....X.X......
........X.....X..XXX.X.X..X..X.XX...XXXX.
.X...XX.X...X.X...X..X...XX.XX..X....XXX.
...XXXX.....X...X...XX..XXX.....X..X.....</walls>
			</board>