<?xml version='1.0' encoding='UTF-8'?>
<board>
				<level>147</level>
				<width>52</width>
				<height>52</height>
				<walls>...X....XXX......X...X...X...XXXXXX....XXXX..XXX....
.X...X..XX..XX.....X.X.X...X...XXXX.XX...XX..XXX....
.XX....X...XXX..X......X..XX...X....XXX......XXXX...
.XX..XXX....XXX...X.XX.....X.....X...XX.X....XX...X.
...X.XX...X....XX.X.XX........X....X..X...XX....XX..
XX....X.X....X.XX.X.XXXXX...X...X..XX..XX...XX..XX.X
....X...X..X.X......X.........XXX..XXX..X........X..
.......XX..X...X...XX.XXXX............X....XXXXX....
XXXX....XX.....X.X....X.....XX..XXXX.....X..X.....XX
XXXXXXX..X..X....X.X..X..XX.....XX...X......X.XXX...
..XXXXXX.XX...XXXX...XXX....X...X....XXXX...X...XXX.
...XXXXX.X.......XX.....XXX...X...X...XXXXX..X..XXX.
.X....X..X.....X.X..X.X.......XX....X...X....X.XX...
.X..X.X.XXXXXX.X...XX.X...XX..XXXX........XXXX....XX
....X...X......XXXXX....X.XX.....XXX...X...XXXX...XX
X....X...............X.XX....X.....X.....X..X...X..X
..XX...X.X.............XX..X...XX....XX..XX........X
..XXX..X....X..XX........XX....XX.XX.....XXXXX...X..
.......XX.X...X...X..XXX....X...X..X..X..XXXX..X....
.......X..XXX.....XXXXX....X..X....XXXX.XXXXX.....X.
XXX...XX.X.....X.....X..XX...X...XXX........X...X...
....X.X..X.X....XX.....X....XX.X..XX...X....X.X....X
.X..X...XX.XXXX.XX..X.....X..X..X...X..X..XX..X..X..
...X...X.........X......X....XX...X....XX.XX.XXX....
XX...X......XX.X.X...X..X..XX..X..XXXX.....X.XX...XX
....X...X....X.....X....XXXXX..X.XXX.....X.X....X..X
.XX...X...XX......XX.XX.XXX....X..XX.......X...X...X
...XXX....X...XXX....X..X....X.XX......XX....X...X..
.......X....X.......X..X...X.X.....X......XX........
..XX..XX..XXXXXX....X....X.........X..X....X......X.
..XX..XXX...............XXXXX......XX.XXXX....X.....
X.....XXXX...X.....X..X....X....XX....XXXXXXX....X.X
X..XX......X.X.X.XXX..XX.....XX...XX.....XXX...X.X..
XX....XXX..X.....X....XX..X..........XXX.....X...XX.
......X....X..X....XX..X..X....X...X......XXXX..XX..
.XX..X..X..X..X...XXXX....XXXX.X........X.XX..X....X
.XX..X....XX..X.X..X....X........XX.X...X.....X.....
.XX....XXXXX....XX...XX.X....XX.....X..XXXXXX...XXX.
....XX.....X........XXX.X.......XXX..X..XXX..X......
XXX...............X.....X..XX........XX...X...XX.XXX
......X...X...........XXX...XXXXXXXX...X....X..X.X..
.X......X.....XXXXXX......X...XXXX.....X.X...X...X..
.XXX...XX..XX...XXX..XXXXXX.....XX.........X.XX.....
...X...XX..XX.......XX...XX..X..........XX.X....X...
X....X..X..X.....XX....X.XX....X.XXX................
X.X.....XXXX.X....X.X..X..X.X....XXX....X........XXX
X.....X..XXX....X...X..XX...X.XXX..XXXX...XXXXXX..XX
XX.......X....X.XX....XX....X..XX............X....XX
.....X.XXX.XX...XX.......X..XX........XX...X...XX...
.XX....X...XXX...X.....X...XX..X...XX....XXX......X.
.XX..........X.X...X........X...XX..X.....XX.XXX..X.
..........XX...XXX........X...X.....X.....XX........</walls>
			</board>