<?xml version='1.0' encoding='UTF-8'?>
<board>
				<level>171</level>
				<width>60</width>
				<height>60</height>
				<walls>XXXX......X........XX....XXX...X......XX...XX......XX.......
XX......X......XXX.XX.....X..X...X....XX.X.XX.........X.....
XX....X....XXX.....X....X...X......X.....X..X..XXXX........X
....XX...X..X...XXX..X...X....XXX...XX....X.X.......XX...X..
..X..X.X....X.X..X..X......XXXXX..X.......X...X...X.XX....X.
X..X.....XX...XX...XX...X..XX..X.....XX....X....X....X....X.
XX.XX....XXX....X......XX..XX......X....XX.....XXX.X...XX...
XX...XX...XX......X.......X...XXX....X..XXX.XX.X...XXX....XX
XXX.....X....X.XX.X..XX.X...X.....X..X..XXX....X.X.....X..XX
XX..X....X...X....X...X.XXX...XX..X...........X..X.XX..XXXXX
...X.....X.XXXXX....X.X..X.....X..X...XX...X..X.............
..X..XX......XX..X.....X...X.X..XX..X....X...XXXX.X...XX....
X...XX..X.......X..X.X.XX....XX.XX...XX....XX..XX...X.X..X..
XXX....XX.....X...XX......X...X....X.XX....XX..XXX..X...X...
....X..XX...X...XXXXX.X...XXX.X.......XXX...X...X..XXX..X.X.
..XXX..X..X...XXX...X...XXX...X...X.X.....X...X.X..XX...X...
X....XX..XX.XXX...X.XX....X....X..X..X.....X....X...X.X.XXXX
XXX..XX...X.X...XX.....X..XXXX...XXX.....X...X....X.X.......
....X...X.....X....X.X...XXXXXX.....X......XX..X.....X.X....
..XX..X..X.X......XX...XXXXXXXX...X.X...X.....X..X.X.X...X..
X..X...X.X...X.X....XXXXXXXXXXXXX.....X...X.....XX...XX..X..
XX...X......X..X.X.......XXX.....X.X....XX...X....XXXX.....X
XXX.....XX..X....X.XX......X.....X...XXXXX.X...X..XX...XX..X
XX..X.XX...XXXX....X..X.X..X..X..XX..XX....XX....X...X....XX
...X..X..XX.....X....XX...XX....XX...XX.......X....X...X..XX
..X..X..XX..X.....X.....XX...XX.X..X.X...XXX....X......X..XX
X...X..X...XX.XX..X.XX.....X......X....X.....XX..XXXX..X..XX
XX....X..X....X...X....X.X...X.X....X.X........X.XX....X....
XX.X..X....X....X....XXX.....X...X..X...XXXXXX....X......X..
XX...XXXX....X...XX.....X....XX..X.....X..XXX...X...XXX....X
..X..XXX..X..XXX.X..X.X.XXX..XX......X.X..X...X.......XXX..X
..XXXXXX.X..XXXX...XX...XXXXXX....XX...X....X...XX......X..X
..XX.....X.XXXXXX....X...XXX...X.........X......XX...X....XX
..XX.X.....XXXXX..X....X.XX..XX..XX...X....X.....X...X.X...X
...X...XX..XXXX..X..X.......X...X..XX.X.X..X...X...X.....X.X
.X.XX..XX..XX...X..XXXX.X.......X.....X.X.........X..XX.....
.X.XX..XXXX...X...XXX...X.XX....X.X.....XXX.....X...X.....X.
.......XX...XX......X.....X..X..X...XX......XX...X....X.....
X.X.......XX...X.X..XXXX..X..X.....X...X..X....X...XX......X
X...XXX.X....XXX...XXXX...X....X.....X..........X........X..
..XX....X.X..XXXX.....X.X.X.X..X..X....XX..XXXX...XX......X.
.....X....X.......X.X.X.....X.XX....X..XX...X...XXXXXX....X.
...X...X..X.X...X.X...XXXX.......X..XXXX..X.X.X.XXXXX..X....
......X...X.X.X...XX...X..XX.......XXX...X..X.....X...X..X..
XXX.X.X...X......X...X.X...X....X..X...X...X...XX...X...X..X
....X....XXX.X...X.......X.X......XX.........X...XX...XXX..X
.X.....X.XXX...XX..XX......X...X..X..XXXX......X........X..X
...X.X...XXXX..XX....XXXX....X...XX...X..XXXX..XXX...XX.X...
X..X...XXXXXXXXXX.........X....XX...X.X..XX..XXXX..X......X.
...XX...........X...X.........XX..X...X...X...XXX...X..X.X..
.X.X..X...........X...XXXX.XX....X......X...X.....X.X..X...X
...X........XX.X....XXX..X..X..XX..X.X...X...XX...X.X...X...
X....X.X....XX...X..XXX...X.XXX...XX...X...X.X..X.....X...X.
..X..X...X......XXXXX...X...X...XX..X..XX..X...XXX.X...X....
.X..XXX..X.X....XX..X.X.......XXXX..X..XX......XXX.X.X...X..
...XX....X...XXXXX..X...X..X....XX..X.....XX.....X...XX..X..
X..X..X..XX......X....XXX...XX...X....X...X...X..XX..XX....X
...X....X...X......XX.....X....X...X....X...X...XXX.....X..X
.X.XXX..X.....X.X....X...XXX...XX....X..XX..XX..XXXXX.....XX
...XXX..XXXX..X...XX...X.....X....X..X..XX..XX..XXXXXXXX..XX</walls>
			</board>