<?xml version='1.0' encoding='UTF-8'?>
<board>
				<level>76</level>
				<width>29</width>
				<height>28</height>
				<walls>XXX...............XXXXXXXXX..
XXX......XXXX...X............
XXXX..........X..X.......XXX.
........X.....XX.X....XX.....
....X.X.X.....XX.X..X........
X...X.....X...XX...X...XXXX..
X.XX...X....X........X.XXX...
X....X.....X....X...XX.....X.
...XX........X....X..........
.X....X.....XX.X....XX...XXX.
.....XX...X..X...X...X.X.....
..XX....X....X.....X...X..XXX
X..X..X......X....XX......X..
...X..X..X...X..XXXX....X....
.X..X..X...X..XX..XX..X.XX...
.XX....X......XX..XXX........
.....X....XXXXX...X....X.....
..X.....X..XXXX.X....X.....X.
X...X.X....X.......X....X....
....X....X....XX......X.X.X.X
.X..X..X....X.XX..X.X.X.....X
.XXXX....XX....X....X..X.....
.XXXX......X.X...XXXXX.......
....X...X....X..XX......XXXXX
XXX.X...X.X.....XX....X....XX
......XXX..XX...XXXXX....X...
.XXX.....X....X...XXX..X.....
.........X..X.....XXX..X..XXX</walls>
			</board>