<?xml version='1.0' encoding='UTF-8'?>
<board>
				<level>118</level>
				<width>43</width>
				<height>42</height>
				<walls>....XX....X.....XXX......XXXXXXXX..XX...XXX
..X.XX.XX.....X...X.........XXXXX...X.X....
X.X........XX.XXX.X...X...X....X..X.X..X...
..XXX...XX........X.X.XXX..X.....XX....X..X
.XXX..X....X......X......X....X...XX....X..
...X......XX.........X......X...X..X.XX.XX.
.....XXX..X...X..X.X...XX..........X.X..X..
..XX...X.X..X.X..X....XXX...XX.X.....X....X
..XX.X.....XX.X...X.X.....X.XX.......X..XXX
XXX..X..X.......X.X.X..X........X....X.....
....XX..XXXXXX.XX...XXXX.X.X...XX.X....X...
.X..XX......X..X.....XXX...X.X......X......
.X.....X......XX.XXX.X.......X...X.XX...X..
...X......XX.X.....X...XX.....X....XXXX.XXX
......X.X.XX........X..XX.XXX...X...X...XXX
....X...X.....X...X.XXX...XXXX....X...XXXXX
....XXXXXXX.......X...X....XXX.XX..........
......X........XXXX.....XX..XX.....XX..X...
......X.X..X....XXX..XX.....X...XX...X...XX
XXX.....X..XXXX.......XXX.....X......X..XXX
XXX.....X...XX...XXXX..X..X...........X....
XXXXX...X.X....X...X...X....XX........XXX..
..........XX.........XXXXXXX...XXX........X
.....X.XX......XX.....XXX.......X..XXXX....
..X..X......X...XXXXX.X...X...X...X.....XX.
X...X....XX.X.X....X..X...XXX..X....XX..XX.
......X...X...XXX....XX...XX...X...X.......
.X...XX.X....XXX..X.......X..X..XX...X...XX
...X.......XXX...X...X....X.....X...XX.X...
.......X.X.....XXX.X...X......X.X.X.XX.....
....XX.X...........X...X...X..X...X.....XXX
..XXXX.XX.X.....X..........X.X......XXX....
XXXXX.....X.X.....X...X........X....XX...X.
......X........X....XXX.....X.XX..XXXX.X.X.
...X..XXXXXX.....X....X..XX...XXX..X...X...
...XXX......XXX.......X...XXXX..XX.X......X
.....X........X.........X...XX..XX...XX.XXX
..X..X.....X..X........XXXX.............X..
..X.X..XXX.X....XXXX...XXX..X....XX........
....X......X...XX.....XXXX..X....XX....X...
.X....X...XX......X.X....X...XX...X.XX.XXX.
...XX...X...........X..X...X....X...XX.....</walls>
			</board>