<?xml version='1.0' encoding='UTF-8'?>
<board>
				<level>99</level>
				<width>36</width>
				<height>36</height>
				<walls>...X..........X.....................
.X...X...X......XXXX...XX.......XXX.
.X.....X...X...XX....X.X......X.XXX.
...XX..XXXXXXX......X..X.X....X..X..
..XXX............X..X....X.....X...X
....X.X........X...X...XX....X..XXXX
......X...XXXX...XXX.X.XX.X...X.....
...XXXXXX.....X..X...X....X.X.XX....
.XXX..XXXX.......X......X...X....X..
.X....X....X...X...XX.......XXX..XXX
...XX...X..XXX.....X...X.......XXXXX
...X..XXX..XXXXXX....X.....XXX......
......XX.......X..X...X....XXX......
XXXX.....X.....X....X......X......XX
XXX..........XX....X...X...X.XX.X.XX
..X.X.XXX.X.....XX.X.....X...XX.....
..X.......X.X.XXXX.X....X..XX....X..
.....XX..XX.X.XX.....X..X...X.X....X
.X.......X..X.....X.X..XX.X...X.XXXX
.X....XX...X....X.X...X...X.........
.XX.......X..XXXX..X....XXX....X....
..X..X....X......X...X...XXX.....X..
X....X...XX......XXX...X.....XXXXXXX
XXXX..XX....XXX..X...XXXXXX.........
XXX...X..........X.....X....XXXX....
..X.X...X...XXXX....X..X.....X....XX
..X.......X...XXXXX...X....X....X...
..XX...XXXXXX........X..X....XX..X..
....XX..X...X..X...X.X....X......X.X
........X.X.XX...X...XXX....XX.....X
...XXX......X.......XXX..XX.......XX
.....X...X....X...X.XXX.....X...X.XX
XXXX.........X..XXX......X..X.X...XX
..X.....XXX..X....XXX..X....X.....XX
....XXX.....X.....X....X..X.XX....XX
........XX..X.......XX......XXXX..XX</walls>
			</board>