<?xml version='1.0' encoding='UTF-8'?>
<board>
				<level>129</level>
				<width>46</width>
				<height>46</height>
				<walls>...XXX......XX..........XX...X....XXXX.....XXX
.......XX....X..........X..X......XX...XXX.X..
..X.XXXX...X.X.....X...X......X...X......X....
....XX...X.X...XXX...X...X......X.X.X.........
.XXX...XXX....XXXXX.....XX...X..X...XXX...X...
..XX.XX.....X.XXXXX.X....XXX.X.......X..X...X.
X.....X.XXX...X..XX....X..XX...X.XXX.X.XX.XXX.
....X...X....X.......X.XX........XXX...XX.X...
.XX........X...X...X...X..X...X.......XX..X.XX
.X.......X.......X....XX......X.....X.X..XX...
...X.X......X...XX..X..X...XXXX.......X.XX....
X....X..X.....X.....XX.X...X.......X....X..XXX
..X...X.......XXX.XX...X.XXX...X.X......X...XX
....X....XX...XXX.XX..XX.XXXXX...X..XXX.....XX
.......XX.....XXX...X.XX.XX...XXXX..X........X
.....XXXX.XX..XX....X.X..X..X..XXX..X.X...XX.X
...X..........XX......X....X...XX.......X....X
.........X.X..XX....XX.....X...........X...X..
XXX...X....X.XX..XX....X...XXXXX.XX..X...X....
XXX.XX..X.......XXX..X....XXX....X...X.XXXX...
..X....X..X...XXXXXX....X...X......X..........
...XX..X....XX..XX....X.XX............XX..XXXX
.X.....X...X....X...X.X.XX.X.XXX....XX....X...
....XX.X......X...X.....X..X..XX..X..X..X...X.
X....X......X..X..XXXX....X...XXX..X..X.XX....
..XX.XX......X.XXX...XXX....XX...X.XX...X..X..
..XX.......X...XXX.X.XX....X...X...X....X.....
.......X...XX..X.....X..XXX....XX..X..........
.XX......XXXXXXX..X.........X..XX..XXXXX.XXXXX
....XXX....XXXXXX..XX.XXX....X.......XX..X....
XX......X.....XXXX..X........X.X.XX...X.......
...X...XX.X.X.X...X...XX.X...X.X.X..X.....X...
.....X.XX...X...X......X...X.....X...X......X.
XXX..X.XXX...X.....X.X....X.....XXXX...XXX..X.
.....X.XXX.X...X...X..X...X......X..X.........
.X...X.X...XX.........X.XX...XXX......X....X..
.X.......XXXX.XXX...X...X..X..X...X.....XX....
......X..X....XX..X.......XXX.X.....XX...XX...
X.....X......XXX....XX...X....XXXX.....X.XX...
X..XX.....X....X.X..XX.......XXXX..XX.......X.
XX.....X..X......X.XX.....XX..XXX.XX..X...X.X.
XXXX...X.XX........X..XXXXXXX...X....X....X.X.
.....X...XX.....X....X............XXXX....X...
...XXXX..XX...X.X......X..XX...X..XX...XX.XXXX
......XXXXX.........X..X....XX.X.XXX.X.XX..XXX
..XXX..........XXXX......XX....X.....X.....XXX</walls>
			</board>