<?xml version='1.0' encoding='UTF-8'?>
<board>
				<level>127</level>
				<width>46</width>
				<height>45</height>
				<walls>.....XX..X...X.......X......XX........XX...X..
.XXX.XX....X...X.....X....X.........X....X....
.X......XX....XX..X..XXXX...X.............X...
....X.......X..XX...X.........X....X.XXXX.....
X.X.....XXX....XX.....X....XX...X....XXX...XXX
X.X..X.........XX..XXXX.XXX..XX...X....X.X...X
..XXXX.X.XXXX...X....X..XXX.....X...XX.....X.X
...XXX...XX...X...XX...XXXX............XX....X
XX...X........XX...XX.....X....X...X...X..XX..
..XX.....X....X..X.X..XXX.X.XX.....X..X..X....
......XX.XXX..X.X....XX.....X..XX..XX.X....XX.
...X.....XXX..X...X...X..X....X...XX..........
.............X....XXX..X........X.XX.X......XX
XXX.X...XX.....X..X....X..X...............X...
XXX...X....XX....XX.X........XXX.XX...XX....X.
..XX......X..XX.....X......X.....X.......X....
.....X....X.....X....X.....XXXXX...X....XX...X
.X.......X..XXX....X.X.XXX...X...XXX..X....XXX
...XX......X.....X.X...X...X........XXX..X....
X..XX...X..X...X...XX....X......X.....XXXX.XX.
X..X..X....XXX.XX.....XXXX..X..............XX.
...X....XX.....XXXX....X....X....X.....XXXX...
.X......X...X..XXXXXXX....X..XX....X........XX
..XXXXX...X.XXXXXX..XXX.X.XX.XX.X.....X....XXX
X..XXXX...............X...XX......XXX...XX....
XX...XX....XXX........XX....XX.X..XX...XXXX...
.....XXX.....X.X.........X..X..X..X..X..XXX.XX
.X....X....X...X.......X.X....X...X.X...XXX.XX
.X.XX...X..XX........XXX...X....X.....XXX...XX
.X......X...XXX......XX........X...X........XX
..X.......X..XXXXX......XXX.X....X...XXX.....X
X...XX.....X...XX...XX....X...X......XX..X.X..
....XX.....XXX....X..........X.......XX....XX.
.......X.....XX...X..XX....X...X.....X..XXXXX.
XXXX.......X....X..........XX....XX..X.XXXX...
XXX.....XX...X.....XXXXX....X.X..X...X..X...XX
XXX.XXXXXX.....XXX...XXXXXX....XXX......X...XX
XXX.XXX.....XX..XXX.....XX...X......X.........
..X......XX.....X...X.X..X......XXX...XX...X..
.......X......X.....X..X.XXXX...X.......XX...X
........X.....XX.......X......X....X.........X
XXXXXXX.......X..X.X....XX.......X.X...XXXXX.X
...X.....X....X..X...XX......X.......XXXX.....
.X...XX....X..X......X....X.......X.......X.X.
........X..X..X......X......X.......XXXX..X...</walls>
			</board>