<?xml version='1.0' encoding='UTF-8'?>
<board>
				<level>96</level>
				<width>35</width>
				<height>35</height>
				<walls>XXXXXXXXXXXXXX......X........XXXXXX
XXXXXXXX..XX......X...XXX..X....XXX
..........X.....X.....X....X..X....
........X...X.X..X....X.XX.....X...
..X..XX.XX....X..X.X..X..XX....X...
X....XX.X..X.....X.X.....X..X......
X..X....X........X...X.XX..XX...X..
XX..XX..X........XX..X..X.XXXXX...X
XXX...XXXXX..XXX....X...X.........X
XXX...XXXXX........X..X..X....X...X
XXX.....X...XXXX.....X...X..X.....X
XXX..XX...XXX....XX....X..X.XX....X
.....XX.......X..X......X...X..X..X
...X.XX......XX....XXXX.XX..X......
...X..X..XXX...XX.......X...X...XX.
......X...XX.........X....X.X...X..
....XXX...XX..X..........XX...XXX.X
....XXXX............X.....X..XX....
..XX.....XX....X....XXXXX.X...X..X.
X..X....XXX.XX...X..XXXXX...X....X.
...XX.......X..XX........X.......X.
.X.XX..X.X....X...XX.....XXX.XXXX..
.X.XXX.X.....X..XXX..XX..XXX...X..X
.X........XX.X......XXX......X...XX
.X...XX............X....X..X..X..XX
...X........X.X.......X..X.XX...XXX
XX....XXX...X...X...X.XX......X....
....X.....XXX..XX...X.......X......
..X......X..X.....X.....XXXXXX.....
X....XX..X....XXX.X..XX..X.......X.
...XX...X..XXXX...X..XXX.X....X..X.
.X..X.XXX....X..XXXXX..X..X...X.X..
.XX...X..XXX...XX...X...X...X...X.X
.X...XX...XXX...X.X...X.XX......X..
...X....X.....X...X..XX......XX....</walls>
			</board>