<?xml version='1.0' encoding='UTF-8'?>
<board>
				<level>80</level>
				<width>31</width>
				<height>29</height>
				<walls>....X..XX.........X............
....X.....X.....X...X......X...
...XX...XXX...X.XX.......X.....
.X.XX....XXXX.X....X.X.........
.X.....X.XX........X...XX......
.XX....X....XX.....XXXXXXXXXX..
..X.X....X........X.....XXXXXXX
X.X.XXX....XX.....X.....X......
X.X...X........X..X....XX.X....
..XXX........X.XXXX.....X...X..
...XX..XXX........X...X..X...XX
XX..X...XX....X...X....X.X.X...
....X...XXXX..X..XX....X.X..XX.
.....X.......XX.....XX......X..
XXXX....XXXXX...X.........XX..X
..X...X...X...XXX.....X......XX
....XXXXX.X.X...X..X....X...XXX
......X.....X...XX...X....X....
....X....XXXXX..X......XXXX..X.
.XX.XX..........X.X.....XXXX...
.XX.XXXX......X.X.......XXXX.XX
....XX...X....X....XX..XXXXX...
...XXX......XXX..X.....X..XXXX.
.X.XX...X.X..XX..XX..X....X....
..........XX..X...X....XX...X..
..X.XX....XXX...X...XX..XX..XXX
..X..X.....XXX..XX...XX........
.....X...X..X...XX.X.X...XXXXX.
.........XX...X....X...X.......</walls>
			</board>