<?xml version='1.0' encoding='UTF-8'?>
<board>
				<level>89</level>
				<width>34</width>
				<height>32</height>
				<walls>X....XXXXX...XXXXX....X....XXXXX..
..XX.......X.XXXXX..X.X.XX.X......
.XX......XXX...XXXX.X......X..X...
....X......XXX.X.......X....X.X...
XXX.....X..XXX...X.XXX....X...XXX.
........X......XXX..XX..X...XX....
...X......X....X....X...XX.....XXX
X..X..........X..X....X.X..X....XX
X.X........XX.X....X....X.X..XX.XX
....XXXX........X......X..X...X.XX
.X..........XX......XX...X..X.X...
.XX.....X...XX......X......XX..XX.
.XX.....X......XXXX...X.X...XX.XX.
..X..XX..........XXXXXX...X.......
X.X....X......X....XX.........X...
X...XX.XXX......XX....X.......X.X.
XXX....X...X.XX...X.....XXXXX.X.X.
....X....X...XX.X.............X.X.
...XX.X..X.........X...X......X.X.
....X....X.......X...X...XXXX...X.
..X..XXX...........XX...XXXX....X.
...X.......X.X.....XX.X...X..X..X.
...XX........X.XX.....XX....XX.X..
X.......XXX....XX...XX...X.......X
..XX.X......X.....X.........XXX...
.XXX...X........X...X.....X..X....
...X..XX...X......XXXXX...XX...XXX
...X.....X.....X........X..X.....X
...X...XXXX....X...XXXX....X.XXX.X
.....X..XXX.X....X..X....XXX.X...X
........XXX.XXX...X....X...X.X....
........XXX.....X....X.....X......</walls>
			</board>