<?xml version='1.0' encoding='UTF-8'?>
<board>
				<level>116</level>
				<width>43</width>
				<height>41</height>
				<walls>XXXX.....X....XX.....X....X.....X...XX.....
XXX..X...X.XX..X.X.....XX...XXX...X.XX.X...
XXX....XXX..XX...X.XX...X....XX..XX....X...
....X...X...XXXX........X..X.XX...X..X.....
......X...X......XX.XX..XX.X....X.XX...XX..
...X..........X.....X...X.....XXX..X..XXX..
.X.........X....X.....X...X.X.X....XX.....X
.X...........X.......X...XX.....X..XXXX...X
.X.XXXXXXXX....X...X.X.X.....X.....X......X
.X.XX..XXX..XX.X...X...XX...X..X...X.X....X
...XX..X...XX....X..X.....X...XX...X.X....X
..XXX....X....X.....X...XXXX..X....X.XXX..X
....X......X........X....XX..XX.XXXX.....XX
......XXX....X.XXXXXX..X..X...X..X..X....XX
.........XX....XXXXXX..XX...X.XX....X..XXXX
.....X......XXXXXXX......XXXX.X...X..X.....
...XXX.XX....X.........X..XXX...X....XXX...
.XXX.........X...X...X.XX.X....XX..X.....XX
..XX..X.......X..X.X...XX......XX..X....XXX
X.XXX......XX...XX.X.XXXXX...XXX...XX......
X...XX...........X.....XX....X...X.....X...
....XX.XX...X....XX.......X............X..X
.X......XXX.....XXX.....XX....X...XXX..XX.X
...XX.X......X..XX..X...XX.X..XXX......XX..
X...X....X...X.XXX....X....X......XXXX..XX.
X.X.XX.X...X.....X...........X........X....
X...X..X...XX.X..X.....X..X..X.X...........
...X..X.....X...XX.XXXXX.....X.X.....X.....
.....XX.X.X.XX...X...X.....X.......X.X...XX
..X.X...X...X..X...X...XX.....X.X......X...
....X...XXXXX.......XXXX..X...X...X.XXXXXX.
.X................X.XX...XX..XXXXXX........
...X...X.....XXXX......X...X.......X...XX..
..XX...X.X...XXX...X.....X.X..X......X....X
.XXXXX.....X.....X......XX..XXX...X...XX..X
...XX..XX...XXX.......X.X...XXXXX...X.X..XX
...XX.....X...X...XXXX....X.....X.....X.XXX
....X.XX...X....X..XX..X......X.X..........
..X...XX.X.X.X.....XX.X....X..X........X...
XXXX.....X.....XXXX.....X....X...X...X.....
XXXX.XX..XXXX.......XX....X..X.....X...XX..</walls>
			</board>