<?xml version='1.0' encoding='UTF-8'?>
<board>
				<level>130</level>
				<width>47</width>
				<height>46</height>
				<walls>...........XXX....XXX..XX....X...XX...XX.......
.XXXXXXXX..XX..X..XXX..X..XX...X.X..X....XXXXX.
..X.......X...X..XXXX....XXX..XX...XX..X...X...
X........XX.....XXX...X.....XX......XXX..X...XX
...X...X..X..X..XXX.....XXX.......X..X..XXX....
.....XXXX.X..X..XX......X....XX....X...XX...X..
..X...XXX.X....XXX.XXXX.X.XX....XX..X.....X...X
......X.....XX.....X......XXXX....X.....X.....X
...X.......XXX..X....X.XX......X.....XX.......X
.X...X.......X.....XXX....XXX....X.......XXXX..
.......X...X.X...X....XX......X.......XX...XXX.
X........X...X....XX............X.XX.......X...
..X...X........XX.XX.X.XX....X....X..X.X......X
...XX.X....XX..XX......XX..X.X......XX.X.XX.X..
.X....XX...X..XXXXXXX....X...X...X..XX...XX..X.
....XXXX..XX.....XX..XXX...XXX.X.X..X...XX...X.
X......XX.X..XXX........X..XXX......X.X....X...
X......XX...XXXXX.....X....XX...XXX...X..XXX.XX
X.XX....XX.....XX.X....XX..XX....XXX.....XXX.XX
X..X..X.XX.XXX.XX....X.XX.XX.....XXX..XX.X.....
...XX.X......X.....X.X.......X....XXX....X..XX.
.XX.......X..XXXXX.....XXX.....XX..X........X..
.......X....XX.............XX....X...XXXXXX...X
XXXX...X.X.....X........X..X..X...X......XXX..X
X..XXX.......XX.......X...XX....X...X......X..X
X...X.....X..X..X.....X..XXX...XX.....X........
X.X...XXXXXX...X..X.X..X...X......XX....X...XX.
..XX...X.....XXX..X....XX.....XX..XX.X..X.XXXX.
.....X.............X......X...XX..X..X.XX.XX...
XXX.....X.....X..X...X...XX..XX.....XX....X....
XX....X...X.X....XX....X..X.....X....XXX....X..
XX........X......XX.X...X...XX....XX.X...X..XXX
....XX......XX...XX.....X..X.......X.......XXXX
.XX.X....XX....X..X..XX.......X..X.XX..........
..X...XXXX...X....XX..X.....X....X.X......X..X.
X..X....X..X..........XX..X....X...X.XXXXX...X.
XX.X..X...XXXXX.....X.....XX...XX....XXX...X...
XX.XX.....XX....X.....X...XX.XXXXXX........XX..
XX.....XX....X.........XX..X...XXXXXXXX....XXXX
X....X..XXXXXX.X.....X.....XXX.................
X.X.....XXXX...XXX......XX....X.....XXXXXXXX...
..X.X.XX.....XXX..XX..X..X..X...XXX....X......X
.XX...X..XX........X...X..X.......XXXX.X.XX.X..
.XX.....X...XXX..X...X....XX...X..XXXX...XX.XX.
.XX.XX..X....X...X..XX..X....X...XXXX.......X..
....XX..XXXX...X..........X..XX..XXXX.........X</walls>
			</board>