<?xml version='1.0' encoding='UTF-8'?>
<board>
				<level>149</level>
				<width>54</width>
				<height>52</height>
				<walls>...........X..XX......XX.....X......XXXXXX..X.........
....XX...X....XX..XXX......X.X....X..XXXXX..X.........
..X.XX.X.XX...XXX...XXX.X..X.XX......XX..X..X......X..
.....X.X..XXX.X.......X...XX.....X.......X....XXX....X
...X...XX..XX......XX.XX..X..X.X......XX.X.....XX.X...
X.......XX.....X.X........X....XXXX......X...X......X.
..X.....XXX....X...XXX......X..........XX..X...X.X....
.XX.XX........XX..XXXX..XX......XX.X....X...XX...X.X..
.XX.XX.XXX.XX.XX.....X....XX....XX....X.....XX.......X
..X....X...XX..X...X...XX...XX.....XX..........XX...XX
X......X.XXXXX...XXXX..XX....X.X.......XXXXXX.....X..X
XX.....X.X....X...XX...X...X.X.X..X....XXX..X...X....X
...XX....X.XX...X....X.X.X.....XX.X...XXXX....X..X....
.XXXXXX....X.......XXX...XX.....X...X......XX....X.XX.
....XXX...X..XXXX..XX...X.......X....X.............XX.
X.....X.X.X.......XX..X...XXX.....XX.X........XXXXXX..
...X....X...XX..XXXX...X.......X.....XXX......XXXX...X
.X...X...XX.XX.......X...XXX.X.X...XXXXX...X..XXX..X..
....XXXX.....X...X.....XX..X.....XXX..XXXX...XXXX.X...
..X.XXX..X.X.X...X.XX..XX.......X.....X........XX.X.X.
..X.XXX..X.....X...XX...X...XX.....XX.X.X...XX..X...X.
..X...X.....XX....X...X...X....X.X..X.....X..XX....XX.
..XXX...XXX.....X.X.XXXX....X....XX....X.....XX..X.X..
XXXXXX...X..X...X...XX...X..XXX......XXX.X....XXXX...X
.......X...XX...XX......XX..XXXX..XX........X..XXX....
....X....XX..XX.XX.XX.X...XXX..X.....XXXX.X....X......
XX..X.XX.....XX.....X.XX....X....XX..X....X..X....X...
...XX...X.......X.X.X....X....XX....XX.........XX.X.X.
..XX....X.X.X.....X........X...X.X..X...XX..X.....X...
X.X..XXX....X..X.....XXX..XX.X......X...XX...XX......X
..X......X.XXX...X...XXXXXXX.XX...X.X..X...X...XXX...X
.X....X..X..XX.......X............X.X....XXXX........X
...XX...XXX.....X...........X.........XX......X.XX....
..X..XX.X.....X.....X...XXX......X...XXX...X..X.XX....
X....X....XX.....XX.X.....X......XXX....X....XX.XXXX..
X.XX...X.X...X...X....XXX.X.......X.....X.X...X.X.....
X.XX..XX.....XXX...X......X..X..X...X.......X.X...X...
..XX......X.....X....X..........X.....XX...X........X.
.XXX.X........X...XX.......X..X...XX.....XXX.X......X.
.XX..X...X............XXXX.X..XX..X..X.....X...XXX....
....XXXX......XXX...X..X...X...X..X...XXXX.X....XX...X
XXXXX.....X.....X.X..X...XX..X.XXX..X......X..X....XXX
.......XX....X....XX....XXX......X.XXXX.....XX.......X
.....X.X...X...X..X...X.XX....XX.X....X...X....XXXXX.X
X....X...X........X.X....X.....X....X...........XX...X
..XX............X......X...XXX....X......X....X.X..X..
.XXXX..XX.....X..X......XX....X......XXX...XX.....XX..
....X.....X...XX...XXXX.....X......XXX.........XXX....
..X...X.X...XXXX....XXXXX.X....XXX......X...XXX.......
X.......X..XX.....X....X..X..X...X.XX.X...X...X.X.....
X..X...XX.......X.X..X.X...X...X...XX.......X...XXX...
XX...XXXX....XX...X..X.....XXX...........XX...........</walls>
			</board>