<?xml version='1.0' encoding='UTF-8'?>
<board>
				<level>111</level>
				<width>40</width>
				<height>40</height>
				<walls>XX...X....X...X...X..X....X..XXXXX......
XX.X...XX...X...X.X..X.XX....XXX...X....
......X...XXXX..X....X.....X.........X..
.XX.X.X.X....X..XX...XXX........X.X.....
.XX.....X..X.XXX...X........XXX.X...X...
.....XXXXX...XXX.X........X..XX.....X...
........X....X...X..XXXXX....XX..X....X.
........X.X..X....XXXXXXX.XX.....X.X..X.
XXX.....X...X.....X.......X....X...X....
....XXX.XX..X.XXXXX....XXX..XX.XX....XXX
......X....XX.XXXXXX.......X...XXXX.XX..
X..XX.XXX..XX....X....X....X.XXX..X.....
...XX.X...XX.....X.XX....X.X...X........
.X....X.X....XXX....XX.X.X.......XXXXXXX
......X...........X..X......X.X...XXXXXX
XXX...X..XX...X...XX....X...X...X.XX....
......X.....X...X.....X.....XX..X.......
...X..X.X...........X....X......XXX.X...
XX.X..X.....XX.X.......X.X...XX.XXX...X.
X........X..X..X.X...X...X...XX....X..X.
..X....X...X..XX...X.XX....X..X.........
.XXXXX.X..XX.........XXXX...X.....X....X
.....X..X.....X...X...X...X....X.....X..
..XX.XX....XX...X...X...X....X...XXX.XX.
.........X.....XX....X.....X....X....XX.
.XX...X......X..X.XX.X..XX....X...X...X.
.XX.....X....XX......XX.....X.......X...
...XXX..XXX....X.X...X...X.............X
.....X....X.X....X.X...X...X...XXXXX....
.......XX...X.X....XX..XX....X.....XXXX.
....X...X..X....X..XX..X....X......XXX..
......X.XXXX.X....X....X.XXX..X...XXXX.X
..XX..X..XXX.X.X..X......XXX.X..X......X
X....X...XXX...X.XX...X......X.....XX...
X......X..XXX..X....X.X.....XX...X....X.
X...X..........X..XXX...X......X...X..X.
X.....X......X.....XX......X.X.....XXXX.
...XX.....XX....XX.XX.XX.X...X..X...XX..
.X..X.........X.XX....XX......X.X.X....X
....X.......XXX...............X...X..XXX</walls>
			</board>