<?xml version='1.0' encoding='UTF-8'?>
<board>
				<level>53</level>
				<width>22</width>
				<height>20</height>
				<walls>XXX...X..........XXXXX
....X..........X......
...X...X...XXX........
.........X..XXXX......
..X...X...............
..X......XX.....X.....
X....X...XX.....X.X...
.....X..X...XXX.X.....
.X...XX...XX..X.X..X..
...X...X......X....X..
XX...X...XX.....XX....
...........XX...XXXXX.
..X........XX.....X...
X......XX......X....XX
..........X...XX.X...X
.X....X.....X........X
...XX....X....X.......
....XX.....XX...XXXXX.
.XX.....X...X......XX.
......X.....X..XXX....</walls>
			</board>