<?xml version='1.0' encoding='UTF-8'?>
<board>
				<level>181</level>
				<width>64</width>
				<height>63</height>
				<walls>.......XX......X..XXXXX..X......X..XXX......X...X..X....XXX.....
....XX..X....X.X..XXX....X.XXXX....XXX...XX...X....X..X..XX..XX.
X...X...XXX..X....XX.....X...X.....XXXX.......XX...XX.XX.XXX..X.
X.XXX.....X.XX..X....X...XX..X.....X....X.XXX...XX.....X...XX...
X....XXXX....X......XXXX....XXXXXX.....X..XX.........X...X.X...X
XX...XXX...X...X.....X...X..XXX.....XX.X.....X...X....X..X...X..
...XXXX..X....XX.X.X...X.X..XXX......X...XX..X.....XX...XXX..XX.
.XXX....X...X......XXX.......X.......XXX.XX....XX..X....XX...X..
.XX..X....X.....X......XX.XX...X......XX....X..X.....X..X..X...X
..X....X..X..X....XXX..X..X...........XXX...X....XXXXX.X..XXX...
X...X..X..X....X..XX.....XX.......X...X.....X.....X....X......X.
XX..........X....X...X....XX....XXX.X...XX..X...X.....XXXXXX....
...X....XX.....XXX......X..X.XX.XXX....XX...X.X...XX...XX....X..
.XXXXXX......X...XXXX.X.XX......X......XX.....XX..X..X.X..X.....
.....X....X..X......X...X...X.........XX...X.....XX.XX...XX...X.
XXX....XX....X....X....XX.X.XXX..X.......X....X.....X......XX...
....X........X..XXX..X..X...XXX....X.X...X..X...XX.......X.....X
.X.......X...XXXX....XX.XX...X..XX...X.X.......X...X...X...XXX..
.X.X..X....X..XXX..X..X....X...X....XX...XXX......X..XXXX..XX...
.X....X.X.....XXXX....XXX...XX....X.......XX....X.X.......X...XX
...XX.....XXXXXXXX..X.....X.XX..X.X...X.X....X............X.X...
XX....XX....XX...XX.....XXX..XX.X.XXX...X..XX..X...X......X...X.
XX..X.....X.X..X.X...X.....X......X....XX.....X..X.....X..XX....
XXX....X....X.XX...X...X.X.....X.....X.....X..X.....X..XXXXX...X
.....X...X......X..XX....X..XX.XXX.X.XXX.X...X......X.XX..X..X..
..XX.......X......XX..XX.......XX..X...X..X..X......X..X.....XX.
X.XXX...XX.XXX.....X.XX....XX...X.........X.X..XXXX..X...X...X..
X.....X....XXX...X...X..X..X..X.XX..X.......X...X....XX........X
XXX.....X..XXX......X..XXXXX.....X.......X....X...XX....XXX.....
....XX.....X......XXX.XXX...XX.X...XX....X...XX..XXX.X..........
..XXXX...X...XXX...XX...X.X..X....XX..X....X..X..X.....X....X...
X........X....XX.X.XXXX...XX....XXXX.XX.......X.....X.XX.XX.X.X.
XXXX...X...XX....X...XXXX.....XX........X.........X.X.....X.....
.....X.....XXXX..XXX.X......X.......XX.......X......XXX.X.XX...X
...XXXXXX..XXX.......X.X.XX.XXX.X...XX.X.......XXX..XXX...XX...X
X..X..X..XX..X.XXX.....X........X.X....X....X...X............X..
..XX..X........XXX..X......XX.....XXX..X.X....X...X....X.....XX.
.XXX....X.....XXXXX.XXX.....X.....XXX..X.X.X.XXX....XX.X......X.
.XX..X....X.X..X......XXXXX..X....XXXXX......X...XXX...X...XX...
....XX...XX....X.X.......XXX...X..XXX.....XXX..XXXXX.....X.XXXXX
..XXXXXX.X..XX.....X.X.....XX....XXXX..XX..XX.X.........XX.....X
...X.....X....X......X..X...X.XX...XX...X...X.......X....XX.....
...X..X..X......X.XX..X...X...XXX..X..X.X.X....X....X..X....X.X.
X...X...XX...XX...XX..X......X..X.XX......XX.......XXXXX...XX...
X.X..X..XX...XX.......X.XX.X....X......X..XX..X..........X.....X
.....X.XXX......XXXXX.X.XX...XX.XX...XX...XXX...X.X.....XX..XX.X
.X.X...XX...XX.X..XX..X.X...XXX......X..X....X....X...X..XX....X
.X........X.X..X...X......X....XX.X..X.X.....X.X...XX.XX....X...
...XX.........X..X.........X...XX....X...XX..X.....X..X.....X.X.
XX....XXXX...X..XX..XXX....X.XX......XXXXX...XX......XX.....X...
....X....X.....XXX..X..X.....X..XX...XXX...X.....X..XXXX..XX....
.XX..XX..X.XX...XX.....X....X..X...X.XX......X.X.X....XX...X....
...X.XX.XX....X......X.XXXX.X......X....X....X.X...XX.X..X...XXX
XX.X........X.....X..X..XX.............XX......XX...X...XXX....X
XX.X...X.XX..XX.....XXX....X...........XXXX.....X...XX......X...
.....X.X.X...XX.XX......X..XXXXXX.....XXXXXXXXX.XX..XX...X....X.
.XX.X....X......XX.X..X....XX..X....X.XXXXXXX...X...XXX......XX.
.XX.X.X...XX..XXX..X..XX...XX..X.XXXX.......X.....X..XX.X.XXX...
..X.....X.....XX..X...XX..XXX....XXXXXX.......XX.....X..X.......
X.XX.X..XXX...XX....X...X.....XXX..XX...XX....XX...X...XXXXX....
.....X.XX...X...XXXX....X..XXX.....X....X..X.....X........X.....
.X........X.XXX...X..XXXX...XX.X...X.X..X....XXX......XX..X.....
......XXXXX.......X.......X....XXX...XXXX................XXXXX..</walls>
			</board>