<?xml version='1.0' encoding='UTF-8'?>
<board>
				<level>93</level>
				<width>34</width>
				<height>34</height>
				<walls>XXXX...X...XX....XX....X...XX.....
.....X...X..X.XX..X..X...X........
.XX......XX....XX..X..X......X....
....X.X..X...X.....XX..XX.........
X...X.X.XX......X...XX....XXX.....
....X...XX...XX...X...X...XX..X...
.X.........X.X........X...XX......
...X.XX..XX....XXX........X..XXXXX
XX...XXX....X......XXXXX..X...X..X
....XX...X..XX....XXXXX..X..X....X
.XX......XXX...X..X......X.......X
.....XX....X.XXX.XX.XX.....X......
XXX........X...X....X...XX......X.
....X.XX.......XX.....X.....XX..X.
...XX.......XXX...XX........XX.X..
......X.........XXXX...XXX..X..X.X
....X.X..XXX...X.....X......X.XX..
....X...XXXX.X...X..........X.X...
..XXXXX......X........XXXX......XX
...XXXX..X..XX....X...X....XXX...X
...X..XX....XX..X...X...XXXXXXXX..
XXXX...X..X..XXXXXX..........XX...
..X..X.X.....X.....XX..X.....X..XX
....XX.X...XXX.XXX.....X.XX....X..
.X...X...X..XX.XX...XX...XX...X...
...X.X....X..X..X.X.....XX..X...X.
X..X....X.XX.XX...XX....XX.....X..
X..XX........XXX.....X..X..X.....X
..XX...X.X....XX.....XXXX.........
...X...X.X..X.XXXX...X.....XX..XX.
.X.X..XX.XX.X..XX....X..XXX...XX..
.X.X.....X.....X..X..XX..X..X....X
.X...XX....X.XXX.X...XXX...XX.....
........X..X.....X...XXX..XXX.....</walls>
			</board>