<?xml version='1.0' encoding='UTF-8'?>
<board>
				<level>114</level>
				<width>41</width>
				<height>41</height>
				<walls>...X.....XXX......XX..........XX.....X...
.X.X.....XXX......X..XXX......X..XXX...X.
...X....X..X....XXX.XX...XXX..X.XXXXX....
..X..X..X....X....X.....X..X..X...XXX.X..
....X..XX...XX.X......X.X....X....X......
...XX.XXX....X.X...XXXX...XX.X......XX...
...XX...X....X...XXXXXXX..X....XXX......X
.....XX...X.....XX........X.X......X....X
XXXX..X..X..X...........X...X.X........XX
XXX...X....X........X......XX.X...X.X..XX
X...X...X....XXXXXXXX.XX.X..X.XX....X.XXX
X.....XXXXX...XX...XX.XX.XX...XX.X.......
............X....X..X..X.......X..XX.....
.XXXXX....X...X.....XX.X...XXX..X....X..X
.XX....XX.XX....X....X...X......XXX..X...
..X.X...X....X.....X.XXXXX..XX....X.X..X.
X.....X...X....XXX.X.....X......X.....X..
..XX......X...XXXX.......X....X.XX......X
.....X......X.......XXX............X..XXX
...X.XXX...X......X..........X.X...X.....
...X.XXX...X.X.XX......X...X.X....X..X...
.......X.......XX........X......X...XX..X
....X....XX.......XXXXX....XX.XXXXXXXXX..
.XXX..X...X......XX..XX.......XXX......X.
.....XX.X.....XX..X.......XX........XX.X.
XXX...X....XXXXXX...XX...X.....X....XX...
XX..X.XX.....XXXX..X...X....X.........X..
XX.....X.....XXXX.....XX..X...X.X..X..XXX
X....X.X.XXX..XXX...X.XX....XXX......XXXX
..X......X....X..XXXX..X.XX.X...XXX....XX
....X...X..XX....XXXXX.X..X...X.....XX...
XXXX..X...XXXXXX...X......X..XX..X..XXX..
XX...X..........XX...........XXX....XX..X
XX.X...X.X........X........XXX....X..X.XX
...X..XX...X.......XX.XX........X.XX.....
....X...X........X.XX....X...XX.....X.XX.
XXX.XXX.XXX......X....X....X.XXX.X....XX.
XXX..XX.XX...X....XXX...XXXX...X...X.....
..XX.......X.XXXX...XX...XXXX............
.......XX....XX.....XX........X.X...X....
..........X..XX.............XXX...X...XXX</walls>
			</board>