<?xml version='1.0' encoding='UTF-8'?>
<board>
				<level>86</level>
				<width>33</width>
				<height>31</height>
				<walls>XXX......XX...XX...X.............
XXX...XX....X....X.X.XX..........
X..X........XXX..X...XX.......X..
...X.X.X....XXX..XX..X...XXX....X
.X.....X......X..X...X.X.....X...
.XXXX...XX......X....X....XXX..X.
......X.X..X.XX...X...........XX.
X.......X..X...XX........X....XX.
X.XX...XX....X.....XXX.....XX....
X.X..X.............XX..XX...X...X
X.X...........X....X..X...X...X.X
..X...XXX...XX..XX...XX..........
.X..XXX...XX...XX....X.........X.
.X.X..X.X......XX....X.XXXXX.....
.X......X..XX.......XX...X...XX..
.......XXX..X.XX.......X....X...X
..XXXX...XX.X..X.X.X......X...X..
....X....XX.XX...X.........X...X.
.XX.X.....X.XXX..XX......X.X.X...
.X..X...X.......XXX...X..X.X..X..
...XX.X.XX......XX....X.XX.XX.XXX
..X...X..XXXX...XX.XXXX....XX....
.........X....X..X..XXXXXX..X....
.XXX...XXX.X..XX.XX.........X...X
.XXXXX.XXX.X.....X....XXX...X....
.XXX...X.......X...XX.XX....X..X.
...X.....XX....X...XX..X.....X...
......X..X...X.......X...XXX.....
..X......X.X....X.XX...X.X...XX..
.....X.X.X....X.X..........X.....
...X...X....XXX.......XXX........</walls>
			</board>