<?xml version='1.0' encoding='UTF-8'?>
<board>
				<level>155</level>
				<width>56</width>
				<height>54</height>
				<walls>....XXXX....XX....X....XX..XXX..XXX......X....X....XXXXX
.XX.XXXX....XX......XX..X....X......XXXX....X...XX.....X
.XX....X...XXX..XX...XX.X.XX.X...X...X......XX..X......X
.XXX.....X...X....XX.XX...XX.X...X.X...XX..XX...X.XXX...
...X.XX...XX...XX..X..XXXXX..X........XXX.....X.X.......
XX......X.X.....XX....X.....XXXXX.X...X...XX.....XXX.X..
X...XXX.X.....X..X......XXXXXXXX..X..X..XXX..X.X.....X..
..X........X..XX.X.XXX...XX...XX...X.X.X....XX....XX....
.......X.....XXX.......X....X...XX.X.X.X.XXX....X....XX.
XX...X..XXX.........XXXX..XXX......X.X...X...XX...X.....
X....XX.....XX..XX...XXX..XXX..XXXXX.......X.....X..XX..
..XX.....XXX....XX.X.XXX........XXXX..XXX....X.X...X....
.....X...X...XX....X...X........XXX.......X....X..X.....
XXX..X.XX....X..X......XX.......X...XXXX....X.....X.X...
X....X....X..X......XX..X...XXX..........X....XXX...XXX.
X.X....X..X..X..........XXX....X...X....X..X..X......X..
..X.X.......XX..........XXXX.....X.X.XX.X.XX....XXX....X
.XX...XX.......XXX......X.....X..X......X.XX......X.X.XX
.XX......X...X.......XX...X...X.XXXXX...........X.....XX
..X......X.....XX.X......XX...X.XXXX...X.XX........XX..X
X.XXX....XXXX..XX...X.XX....X...XXXX.X...XX....X.......X
X.X...X..X.....X......XXX....X..XXX..XXXXXXX...XXXXX...X
X.....XXXX.......XXX...X...X...XXXX....XX....X....X....X
..XX..XXXX....X....X.X...X.XXX.XXX..XX.XX.X.........X...
....XXXXX..XX....X.X....XX..XX.XXX.....X....X....X......
.XX.....X...X..X.X.XXXX...X....X...XX....X.........X.X..
.XX.........X..X...XX.......X..X.X....X..XXX...XX..X....
.XX....X.......X....X..........X...X..XXXXXX......X...X.
.....X....XX...X.XX........XXX.....X..XXXX....X...X.X.X.
..XX.XXX..X..XXX.....X...XXXXX..X..XX.......X...XXX.X.X.
...X...X.XX.X.....XX...X..........XXX.....X...XX....X...
.X...X....X.......XXXX........XX.....X...........XXXX..X
.X......X....X..............X.XX...X.X...X.....X..X.....
.X..XX...XX.........XXX...X......X...X.......X....X.XXX.
.......X..X.X.....X.....X..XXX.....X......XX...XX.....X.
XXXXX..XX.....X.X..X....XX....XX.....XX...XX.......X....
X...X....X......X..X.XX.....X.XX.XX.....XXX..........X.X
X.X...X......XXXX..X...X..X...........X.....X.....X..X..
X.X.....XXX...X....XX..X.....X..XX.........XX.XXX.....X.
..X..X......X....X.XX.XX.X...X.XXX.....XX..XX.X....XX...
...X...XXX.....X.X..X....X.X...XX...XX....XXX....X..X..X
XX.....XXXXX........X..X.......X..X..X...XXX...X..X.....
X............XXXX....XXX.XX....X.XXX.....XX..XXXX.....X.
..XXXXX........X.....X.......XXX....X....X..X......XX...
...XX...X........XXXXX..XX...XXXX..........XX....X.XX..X
XX.X......X...X...XXX...X..XX..XX..X....X..........X....
...X.X......X...X.....X...XXX..XXX....X.....XX..X.XX.XX.
.X.....X........XXXXXX.........X....X....X..XX....X..XX.
.........XXXXX..XXX..X...X...X.........X...XX..X....XXX.
XXX.......XXX...X....X.....X....X..X.....XXX..X..X..X...
..XXX...X.....X.X..X......XXXX....XXXXX......X..XX....XX
..X...X.........XX.XX..........X....XXX........X...X....
....X...........XX....XXXX...XXX.XX..X...XXXX....X....X.
......XX........XXXXX......X.....XXX...X........XX..X...</walls>
			</board>