<?xml version='1.0' encoding='UTF-8'?>
<board>
				<level>230</level>
				<width>81</width>
				<height>79</height>
				<walls>....XXXX...XXXX....XXXX........XX..X.....X....X......X...X...XXX......X....X....X
..X....X...XXXX....XXX..........X....XX....XX...XXXX...X.X.X.XXX.XXXX....X...XX..
X...XX.XX..XXXXXX..XXX....XXX.X.X...XX..X.XX...XXXX....X.....X...XX....X.XX..X...
....XX.....X...XX..XX...X...X.....X....XX....X.XXX..XX..X...X....XX.X....XXXX..XX
.X....XXXX...X.....XX.X........XXX..X..XXX...X.X...XXXX.....X.X..XX.....XXXX..X..
.X.....XXXX..XX..X....XXXX.........XX..XXX.X.X.X.....X...XX.....XX...X....XX.....
.X...X......XXX.....XXXX....X...X..X.......X...XXXXX...X.....X..XX.....X....XX...
...XXX..X.....X.X.........X...X.X..X.X...XXXXXXXXX..X..XXX...X.XXX....X..XX......
....XXX.........X.XX....X.XX.......X...X...XX..........XXXXX...XXX.X....XXXXXXXXX
....X....X.....X..X...X...X..X.X...X..XX....X........X....XXX......X.X...X..XXXXX
XXXXX..X.XXX.X...X..X....XX....XXXX...XX..X.X...XX......X.....XXX.....XX....XXX..
.......X...X.....X.XXX...XX.X...XXX.X.XXX.....X.X.....X....XX.....X.X.....X.X....
.....X.X....XXX....X.....XX...X..X....X....X..X...XX..X..........X..X.......X....
X....X....X.XX..XXX......X....XX...X....XX....X..X....X......XX..X.......X.......
X...X.....X....XX...X....X...........X..XXX...XXXX..X....XXX....X......X....XX...
XX....X...X..........XX..X...X................X..XX....X..XX.X....XXXXXXX...X....
X..X....X..........X....XX.X......X...XXXXX......X.....XX......X.XXXX.......X.XXX
..XXXXXX...X..........X....X..XXX.X.....XXX....X...X..XXXXX.X..X.XX....X....X....
.X...XX..XXX..........X........XX.X.....XXXXXX.XX..X....XX..X.XX.....X...X.......
.X.X.XX.XX..X.........X.....XX......XXX......X.....X.X.....X..X....X..X..X...XXXX
...X....XX..X..XXXX......XX.XX...X.XX.....XX.XX......X.X.....X..X..XX.X.X....X...
......XX....XX.XX....X.X.......X.X.....X..XX......X..........X.XX.XXX.X.X......X.
.XX.XXXX..X..X....X....X...X.XXX.....X...XXXXXXX..XXX...XXXX.X......X......XX....
.XX..XXXX.XX..XXX...X........XXX..XX................X......X...X.....X...X......X
...X....X...X.....XXXXX...XXX.........XXX........XX........XXX.X...X...X.X..XXX..
....XXX.................X..XX.......X...X......X............XX.X...X.....X....X..
..X........XXXXXXX......XX.....XX...X.X.XXXXX........XXXXXX.XX...X....XX...XX....
XX...XXXXXX.........XXXXX....X....X.....X.....X.XXX..X....X...XXXX..X.....XXXXXX.
...X..XXX......XX.X.......XX...X..XXXX.....X..X.....XX.XX..XX..XXXX.....X........
..X...X....XX..X..XX...XX......X..X......X...XX....XX..XXX...X..XXX..X.....X....X
X.X.....XX..X.XX.....X....XXX..XXX..XXXXXXX.....X..XX.....XX....X......X.X...XX.X
X....X..XXX......XX......XXX....XX...X......X.X...XX..XXX..X.......XXXXX...XXXX..
X..X....XX...X.X..XXX.XX.XXX.XX....X.....X..X......X.......X.XXX.X...............
...X..X....X...XX.....XX...X.....X....X..X.......X...XXXXX...X...XX...XXXXX..X...
.X.X..........X....X...X...X...X..X.....X..X.....X.....X.......X....X...XX...X.X.
...X......X.XX...X...X.......X..X......XX......X.....X......X.......XXX....X.....
..XXX.....X....X..........X...X....X...XX...XX....X.....X...X.X.X...X......XX...X
...XX..X.......XX...X...XXX.X..XX....XXXX.......X...X.X..XX...X.....X.XXXX....X.X
...XXX.X.......X....X.X..X..XX.XX.X......XXXX.........XX.......X....X..X..X...X..
XXXX.......XXXX..X....XX...XXX.X....XX...XXX.......X...X..XXXX...X..XX....X..X...
.....XX.XX...XX....X.........X.X.X......X....X.......X.X..XX..............XX.X.XX
..X..X..X.......X......XXXXX.X........X.X.XX...XXXX....X.....XX.XXXXXXXXX......XX
X...XX....X...X.XXX....XXXXX.XX...X.......X.....XXXXX.XX..X..XX..XX..XX.....X...X
......XX..X..........X...X...X....X.XXXX....X.X....XX.XXX.XXX..X.....X.......XX.X
.X.X..XXXXX....XXXX..XXX...XX..XX.........XXX..X......XXX..XX........X.X...X..X..
.X...XXXXX..X.......XXXXX..XX.X....XX...X...XX...XX....XXX..X...XXXX.....X..X....
.XX......X.........XXXX.....X...XX..X.X.......X......X....X...XXX....XX.....XXX..
....X....XXX...X.....XX.XX..XXXXXXX...XX...XX.....X....XX.X....XX....XXXXXX...X..
......XXXXXX.X...XX...X....XXXX..X...XX..X...XXXXX..X...X...XX.XXX...XXXXX....X..
.....XXX...X......X.X.XXX.....X....X..X....X..X....XX.X.XXXXXX.X.....XXXXX.XXX...
......X..X......X.X....X..XXX.X...XXX......XX.X.X.....X...X....X..X..X.....X...X.
....X...XX..XXXXX....X...XX...X........XXX.XX.....X....XX...X...X.X..X.X.....XX..
.....X...XX..XXXX..XXXXXXXX..XX....X....XX...X.........XX..XX.X......X.......XX.X
.XXX...X.X...XX.....XX..XXXX.XX.XX......X......X...XXXXXX.....XX...X....XX...X..X
.XXXX..X.X.X..X.XXX.X...X.......XX........X.X....XXXX.....XX..XXXX.XX........X...
...X...X.X.XX...X...X.X.....X....X.....X....X.X...X.....XXXX.....X........X..XXX.
...X...X...XXX..X........XX...XX..XX...XXX....XXX...XX.....X.X.......X......XX...
....XXX.....XX.....XXX....X.......X....XXX..XXXXXX.....X.....X.XX......XXX...X.XX
..X.....X...X........XXXX....XX.....X..XXX.....XX....X...XX....X........X..X...XX
..X..X....XXX.....X...XXXX...........XXX...X...XX.........XXX..X....X...X.XX.....
..X..X.X......XX....X....X.....X...X...X......XXX...X...X...XXXX....X..XX........
..X....X...XX....X.....X...X.....X..XX......X.....X.X...X....X...X..XX.X..X...X..
XXX.XXXX...XXX...X.X...X.........XX.....X...........XXX....X...X....XX.X....XXX..
....XX...XX....X..........X.XX......X.X......XXXXX......XX....XX.XX......X.......
...XXX......X..XXXX...X.X.X.......X.X....X.....X...X..X.....X.......X...XX..XXXX.
XX.XX.......X...XXXXXXX...XXXXX...X...XX....X....X....X.......X...X...X...X.XXX..
...XX.XXXX....X.....X.....XXXX....XXX.....X.X...XX..X...XXXX....X......XX.X...X.X
.XXXX.XX...X.....XX...X.....X..XXX.....X......XX..X...XX.....X.....X.X..X.......X
....X.....XXXX...XXXXXX.......XXXX.X.XX..X.X......X...XX.........X...XX.XX...X...
X.......X......X...............X...X.X..XX......X......X..X...X...XXX...XXXX...X.
X.XX.X...X....XX...X..XX..XXXX...XXX.X.X..X...X..X...X.X....X...X..XX...XXX...X..
.....X.X...XX...X..X.....XXXX....X...X........XX...X.....XX.....XX........X.X...X
.X.....XX..X....X.XX...X...X..XX...XXXX....XXX....X.....X....X..X..X...X....XXX..
..XXX......X.XX...XX.XXX...X..........X..XX..X..X...X..........XX......X.X.......
X....XX....X.........X...........XXXX....X...XX.XX..XXXX........X...XXXX.........
...X.....XX........XXX.XX...X....XX....X...X..X......XX....XXX..X.....X...XXXXXXX
.X..X.......XX...XXXXX....XXX..XX...XX.XX.....X.........XX.....X...XX...X...XXXXX
.XX.....X......X..XXXX.....XXX..X.......XXX........XX.........XX.X..XX...XX..XXXX
.....XX...........XXXX.....XXXX.......X..........X..........X....XX....X.....XXXX</walls>
			</board>