<?xml version='1.0' encoding='UTF-8'?>
<board>
				<level>156</level>
				<width>55</width>
				<height>55</height>
				<walls>.......XX........XXXX.....XX..XXXX....XXX..X...........
...XXX.XX..XXXXX..X.....X.X...X....XX...X..X.X......XX.
X..XXX.XXX......X.........X.X...X..XXXX....X...X.......
..XXXX.XXXXXX.....XX...X..X..XXX.....X.....XX....X...XX
.XX....X......XX.....XX...XX...........XXX....XXXX...XX
..X.......XXXXX..X......X.XX..X.....X.XX...X..X...XX...
X....XX.X..XX...XX...X..X.XXX.........XX.....X..X....X.
...X....XX....XXXXX..X....X...............X....XX..X...
.X.X..X.....XXXXX...X..X.....X..........X...X...XXXX..X
.X......XXX..X.....XX......X...X.XXXXXX......XX...X....
.X....XXXXXX...X.X.XX...XXXXX....X....X..X...XXXX...XX.
...XX.....X....X......XXXXX...X.....X....X..XXXX....XX.
..X.......X.XX....X.XXXXX.....XXX.X...XX.XX...XX.......
XXX.XX..XXX..XX...X.......XX..X...X......XX....X...X.XX
XXX..X.......X..XXXX......XX..X........XX....X...X...XX
XXXX...X...X...XX....XX...XX....XX...XXXX..XXXX..XXXX..
XXXXXXX..X........XX......XX.......XX......XXX...X.....
......X.X.....X...XX.XXX..X..X...........X.X...X.X.X...
....X.....XXXXX.X....XX...X..........XX....X...X.......
..X...XX......X..XXXXXX.....X...........X...........XXX
..X........XX.XX.........X..........X..X....X...X....XX
.....X........X........X...X...XX...X..X.X......X.XX.XX
.X......XXX.....X...XX.XX....X.....XX....X.X....X..X...
......X....X..XX..X.XX..X.X....X.X.X..XXXX....X.XX.....
..XXXXXX...X.....XX..XX......XXX.....XXXXXX...X..XX....
XXXXXX.......X....XX.....X.X..X...XXX........X...X.....
..................XXX....X..X.X.....X..XXX.X.X.....X...
......X.......X...XXX...XXX.........XX..XX.....XXXXX...
XXXX..X...X.....X.XXXX.......X...XXX..X.....X........X.
.....XXXX.....XXX......X...X..XXX.....XX......X........
....XXXX...X..X..XX...XX....X.X...X...XX.XXX.....XX.XXX
..X...XX.....XX...X.X..X..X.X...XX..X.XX.....X.X..X...X
..X....XXXX..XX.X.X.XX..XX..........X..XX......XX.....X
X....X......X...X...XXX.XX...XXX.......X..X.X......X...
.....X..XXX.X....X...XX..X...X...X...XXX.XX...XXXX.....
.X...XX..XX....X...X..XX...X....XX....XX..XXXX..XXX.X..
...X.....X...X....X...XX......X.....X.XXX........XX....
.....XXX...X.XX.....X............XX.X..XXXX....X...X...
..XX.XXXX....XX..X......XXXXXX.XXX.....XX....X.X.....X.
...X...XX.....XX.....X..XXX....X...X.XXX...X.X.X..X..X.
...XX.......X.....XXXX.XXX..X.....XX..X..X...X.X..X.X..
XXX...X.X...XXX....XXX...X.XX.X.X...X...X......X....X.X
........X..XXX.....X.......X..X.....XX..X.....XX.X....X
...X.....X.....XXX...XX......XXX............X....X.....
...XXXXX.XXX....XX..X...XXX..XX....XXXXXX.......X......
.....XXX...X.XX...X...X...X..X..XXX..XXXX..X.XX...XXXXX
..XX.X...X......X.X..XX......X.......XXXXX.X.....X..XXX
..XX...X......X...X......XXX....XX...X.......X......XXX
......XX..XXX..X.....X.X......X..XXX......X.....X...XXX
....X.XXXXX....X.X.X.X.....XX..X....X...X.X.XX....X.XXX
..X...X...X..X...X...XX......X..X...XXX.....X..X....X..
X.......X..X...XX....XXXX.X.....X.XXX....X....XX.......
..XXXX..XX........X....XX...X.......X......X......XX...
.X......X...X...XXX.X...XX...XXX.XX....XX....X.XX....X.
...XXXX...X...XXXXX...X....X.....XX..X....XX...XX..X...</walls>
			</board>