<?xml version='1.0' encoding='UTF-8'?>
<board>
				<level>168</level>
				<width>59</width>
				<height>59</height>
				<walls>....X....XX...X...X...XXX....XXX........XX..XXXX.......X...
.XX...XX..X.X...X...X...X.XX...X......X.X...XXX....XXX...X.
.....XXXX...X..X...XXXX.....XX..XXX...X...X.X...X........X.
X........XXXX....X.......X......X.........X.......XX.......
X...X.XX......X.....XXX....XXXX...XX...XX...XX...X...XX...X
X.....XXX.....X..XX.X...X....XX......X.........XX....X..X.X
X.......X.XXX.XX..X......XXX.......X.XXX.....X....X..X..X.X
..XXXXX.......XXX...XX.X......XX.X.......X...X...XX..X..X.X
.XXXXX...X....X..X.....XXX....XX....X......X........XX....X
.X...X.XXX..X....X.X.....X...XXXXXX...X.........X......XX..
.X.X.X..XXX....X.........X.....X..XX......XXX...X.XX.XX....
...X....X....X.XX...........X..X.......XX....XX...XX.......
XXXXX........X.XXXX.....X.X...X..XXXXXXX.....XX..X....XX...
....X...XX.XXX......XXX.X.....X....XXXX..X..XXX....XX......
....XXX..X..XXX....XXX..XX.......X..X...XX....X...XX...XXXX
X...X..X..X.....XX.X...XXXXX...X..X.....X..XX...X....X.X...
X.X....XX......XXX.......X...X.XX....X....XXXXXX....XX.X...
X...XX..X..XX.......X.XX.X.X.X..X..X.X...X.......X...X..X..
XXX..XX..X....X.XXX.X.X....X....XXXX...X......X....X.XX....
XXXX...X.X.XXX..X...X.X.X........XX.............X........X.
.........X.....X..XX..X........X.....XX......X......X....X.
....X.....XX.....XXX.....XXXXX.XXX.X.XXXX......XX.......X..
..X.XXXXX....XX..XXXXX...XX........X........XX.....X.X....X
..........X..X......X....X..X.X.....XXX..XX......X.X...X...
.X.X.........X.XX.....XX...XX.....X.X....X..X.X..X....XXXX.
...X....XX...X....XX...X..X....X..X....X...XX....XX......X.
......X....XXXXX.....X..X.X.X....X...X.XX....XXX.X.....X...
....X............X.X..X.....X.X....XX............X.X...XXXX
XXXXX..X..X.X......XX....X....XXX...X.X.XX..X....X...X..XXX
XXXXXX.X....X.X...XXX..X..XX..XXXXX...X...X...XX........X..
XXXXXX...X......XXXXX..XX..........X..XXX.........X........
XXXXXXXX.....X...X..XX..X..XXX.......XXX.....X......X....X.
......XX..X....X....X...XXX.......X......XXXXX.XXX....XX.X.
...XX...X...XX.XX...X.X...X.X.X...X.......XXXX.....XXX.....
XX....X....XXX.XX...X.XXX.....X..XX.......XXXXXX...XX...X..
XXXXX....XXXXX....X...XXXXXX...X....XX........XX.X.X..X....
.......XX...XXX...XX..XXXX.....X..X...........X..X.X.XXXXX.
....XX....X.X.....XX....XX.X........X.X..XXX..X.XX.........
..X......XX...XX.....X...X.........XX....X....X.X...XXX...X
X....XXX.....XXX...X.X.X..X.X........X...X.XX...X.X.....X..
..XX.XX...XX.....X.....XX...X.....X......X...X..X....X.....
.XXX....X.XX..X.....XXXXXXXXXXXXX.X...X...XX.X.....X...X.XX
....XX....XXX...X.X...XX..X.........X...X.XX...X....X....XX
XXX....XXX....XXX...X.XX..X......X.XX.XXX......XXXX...X....
......XXXX..XXXX...XX.....XXXX...X..X.X.....X...XXXX..XXXX.
..........X......X........X....XXXX.....XXX...X....X..XXXX.
.....X....XX....XX........X.X....X...X...X.....XX......X...
.X...X....XX.XX..X.....XX.X.XXX..X.X..XX...XXX.XX.X.XX...XX
.X..XXXXX.X..X...XXXXX....X......X..X.X....XXX......X.....X
..X.....X...XX.....X.......XXX......X...XX...XXX...XX.XXX.X
X.X..XX........XXX.X...XXX.XX.....X....XX.....XX....X...X.X
..X...X............XXX.....X..X.....XX....X.X....XX.XX....X
....X........XX.....XXX....X.X...X....XX..X.X..X....X..X...
XX.......X.......XX.X...XX...X.X...X..X...X..X....X...XXXX.
XXXX.X......X.X..XX.......X..X..XX...X..X..X......X........
...X...XX.X...X.XX...X.......XX........XXX...XX......X...XX
.X......X....XX....X.......X..XXX...X....X........XX...X...
....X.X....XXXX..XXX.....XXXX.X...X...XX.X....XXX....XXXXX.
..X...X..XXXXXX..XXX.....XXXX...X........X..XXXXX..X.......</walls>
			</board>