<?xml version='1.0' encoding='UTF-8'?>
<board>
				<level>152</level>
				<width>55</width>
				<height>53</height>
				<walls>XXXX..X...X....XXX........XXX.....X........XX....X.....
......X.X....X..XX.....XX.XXX.....X...X..X....XX.......
....X......X..X...X....XX.XXXXXX..XX..X....X..X...X....
..X.XXXX....X...X.....X...X.......X..XX......X..XX..XX.
..X.......X........X....X.......X.X.XXX...X..X.....XX..
..XX......XX.....X...X.....X....X.X.....XX..X..XX.....X
...X....XXX..X...........X...X....XXX......XX.......X..
...XX.....X.......X...XX..X..X...XX......XX...X........
X..XX..X....XXXX..XXX..XX....X...X...XX..X..XXX..X..XX.
...XXX...XXXXXX..XXXXX.....X...X...X.X..XX...XXX.X...X.
.X...XX..XXXX...XXXXX....X..X..XX..X...XX..X.......X...
.XXX.....X..........X.......X.XXX.....XXX.......XXX...X
..X....X...X...X..X.......X...XX....X.X...XXX.......X..
X...X..XX......X..X..X.......X...X......XXX......XXX...
X.....X...X.......X..X..XX.X...X.....X.......X...X...XX
X....X..X.X.....X....XX....XXX..........XX...X.XX..X...
X..X...XX...X........XX..XX....XX...X...X..X...X..X..X.
X..XX..XX..XX..X..............X...X....XX......X....XX.
XX.....XXX...X.....XXXXXXXXX....X....X.X..XX.....X..X..
XX...X.....X.XX....XXX..XX...XXXX..X...X...X.XX.......X
XXX..XXXX..X..X.X..XXX..XX.XXXXX.......XXX....X...XXX..
....XXXXX.....X.X..XXX.....X.....XX.....X...X.X.....X..
.XXX.....XX........X...XX....XX.......X...X.......X....
.....X.....XXXXX...X.........XX...XX...X.....XXXX.XXXX.
X..............XXXX...XX.X......X.XX.X...XXX..XXX..XX..
X..XXXX...X......X..X.XX....X...X....XX.......XXXX..X.X
XX......X.X.X......XX...XXX.......XXXXXXX.XXX.....X...X
XXX.......X..XX...XXX........X.XX.....X...X.....X.XX...
XX..XX.X...X..X....XX..X.......XXXX.....X....X....X..X.
XX.X...X.X..X......XXX....XXX....X...X....XX...X....XX.
.....X......XX.....XX...X.....XX...X...X..X......X.....
.XX....XX........X..X.X....X.......XX..X..X........X...
.XXX..X....XX.XX.XX...XX.XX..X.....X...X..XXXXX......X.
...X....X.....XX.X....XX....X.....XX.X...........XXXX..
.....XX...X.XX...X....X.....X.XX.....X..XXXX.......X..X
..XX......X..........XX.XXX.X....X....X....X...XX....XX
..XX...X..XX..X...XX.X..XXX.X...X...X...XX..X..XX...XXX
..XX....XXXX..XXX.XX...XX.....X...X..X..X...X.X...XXXXX
......X....X...XX...X...X.XX.XXX...X......X.....XXXXX..
....XXX..X...X..XXX...X......X...X.X..X..........XX....
X....XXXXXX..XX.....XXXXXX.......X..X....X.....X.......
..XX..X......XX..XX..........XX..XX....X..XX.X.....X...
.XX...X....X...X...X....X....X.....XXX..X....X..XX.....
.XX....X...XXX...X......X..XX..X...X..X....X.....X..XXX
.X.....X.XXXX.......X...XX..X.....XX...X...X...X......X
...X...X.XXX..XXX...XXX..XX.....X.X..X.XXX.....XX...X..
XX...X....X..X.....XX....X..........X..XX..XX.....X....
.....XX.X.X....X.X.XX.XXXX.XXXXX.X....XXX.....X......XX
..X.....X.XXX..X...X..XX.....XX..X...XXX..X........X...
X.XXX.X...XX....X..X......X.....XX....XX....XX...X.....
..XXX.....X..XX.XXX...X...X.X....X..X.X......X.X....XXX
..XX...X..X...X..XX.X.XXX.....XX.X..X...XXXX.X.X.XX....
.....X........XX....X......XX....X..X..XXXXX...X.......</walls>
			</board>