<?xml version='1.0' encoding='UTF-8'?>
<board>
				<level>132</level>
				<width>47</width>
				<height>47</height>
				<walls>........X....XXX..XX..XX..XX...XXXXX........X..
......X....X......X...XX..XX.X...XXX.....XX.X..
XX.......X......X...X.X...X..XXX.XXXXX....X....
XX.X...XXXX.....X..XX...X.X.XXX..X......X.XX...
X....X.XX....X..X...XX....X..XX.......X...X....
..X....X...X.X....X....X...X........X.XX....XXX
.XX......X.....X...X...XXX.XXX....X......X...XX
............X.XX.X.........X....X......X.XXX.XX
X...X...X...X.....X...X.......X....X...X..XX...
..X...X.........X..XX...X...X..X.......XX...XX.
.XXXXXXX.....XXXXX...X..X.X....X..X.....X...XX.
.........X...XXXXXX.......XX...XX.....X........
..XXX........X......X.XX.....X.XX.....XX...XXXX
..XXX...X.X..X.XXX..X.....X....X....XXX..XXXXXX
XXXXXXX.X.X..X...X..XXX.X.XXX....X....X...XXX..
........X.X..XXX.XXXXXX.......X....X......X....
.....X..X....X....XX.....X....X...XX.X.XXX.....
..XX.XXXXXXX....X....XXX.....X..X..X...X...X...
...X.....XXXXXX....XX.....XX.X..XX.X..X......X.
.X..X........XXXXX....X...XX.X.....X....X.X....
.XX.X.X..............X..X.XX.X.X.....X....X.X.X
....X...X..XX.X......X....X..X...XX....X......X
X..XXXX.X.....X....XXX.XX...X...X..........X...
...X..X...X..XX..X...X......X.X.X.....X........
.X....XXXXX..XXXXXXX...XXX....X.....X.X.X...XXX
...XX...X....XX....X.......X.....XX.X.....X..XX
XX....X...XX.XX.XX......XX...X....X....X..XX...
XXX.......XX........X.X...X....XX....XXX.X...X.
....XX.........X......X.X...X......XX..X...X...
...X...XXX.......X...X........XX....X.....XX..X
X..X.X........X....X...X.X...X....X.....X..X..X
..X..XX...........X....X.X.X....X.XX.......X..X
.XX...X...XXXX....X.X..X.X.XXXX...XX...X......X
.X....XX..XXX...X...XXXX...XXX.........X..X.X..
...X.....X....X....XX......XXX.X...XXXXXX.X....
........X..X..X....X....XX.....X.X...XX........
....X.....XX..X.X..X.X..XX..XX...XXX.....X.XXXX
X.....XX.XXXXX..X..X.X..........XX.....X.X..XXX
..X..XXX...XX..XX..X.X....XXX.X..X.......XX.XXX
.XX......X.XX.XXXX...X..X...X.XX......X.....X..
.XX...XX.X..X.....X.....XX....X.......XXX......
....XXXX..X.....X.....X....X....X....XXX...X...
..X...XXX...........XXXXX....X....XX...X.X...X.
..X.X.X...............XX..X......XXXXX...XXX...
....X......X...X...X...X....X.............XXXXX
.X..XX...X.X.X.X.X.X.X...X.....XX.....XXX....XX
.......XXX...X...X...XXX...XXX....XXX........XX</walls>
			</board>