<?xml version='1.0' encoding='UTF-8'?>
<board>
				<level>179</level>
				<width>64</width>
				<height>62</height>
				<walls>....X..XXXX..X........XX.....X....X...X......X.....X............
....X....XX....X...X.....XX....X....X...XX.....XX..X......XX....
...XX.....X.X....X...X......X....X.XX..X....X.....XX....X..X....
.X.XX...X...X...XXX..X.....XX..XXX..X.....X.X..X.....X.....XX...
.X..X....X.......XXXX..XXX.XX.......X...X.X..X...X.....X........
.XX....X...X...X...XX.XXXX....XX...XXX.......X......X...X...XX..
.XX..X....X..X......X..XXXX......X..XX..XX........X...X...X.....
..X..X..X...XX....X....X......XXXXX..XX....XXXX.XXX..XXX..XXX...
X.....XXXX........X..X...XXX.......X..XXX.......XXXX......X.....
..XXX...X..XXXX....X...XXXX..XX....XX..XX.X......X......X...XX..
...XXXX...X.....XX..........X...X....X.........X......X...XX...X
.X....XXXXX.XX..X..XX...X.......X........X.XX.....X...X......X..
....X...X...XX.XX...X...X...XX..X.....XX...X..X.X.....X....X..X.
..X.......X.......X...X.....XX..X...X..X.....X..X..X.....X....X.
..XX...XX...X...XXXX.....X...XXXXXX....X....X..X.....X...X..X...
.....X....XXXXX..X...X.X...X..XXXX..XX....X...XX..X..X...XX....X
.......X....XX...X.XXX......X....X....X....XXXXXX.X..X.XXXXX...X
XXXXX....XX....X...X..X..XX.X..X...XX..XXX...X.......X..X......X
..X...X...X..X...XXX....X...X..X....XX.....X...XXX.X....X..XX..X
....X...X..X.........X..X....XXX....X......XXXXXX..XXX...X....XX
...XXXX.XX...XX...XX...X.....XXXXXX...X...XXXX....X....X..XXX...
.............X..X........XXXX...XX..XX..X....X.......XXXX...XX..
XXX...XX.......X..X...X...X........X...X...X...XXX.X.X...XX.XX.X
X...X.X....XX....XXXX...X....X...XX..X...X......XX.....X....XX..
..XXX...X.....X..XX.....XX...X...X..XX....X...X.....X........XX.
...XX..X..X.X....XX........X.......X....X.X....XX........XXX....
XX...XXX.XX.X..X.XXXXXXX.X......XXXX..X......X..X..X.XXX.XXX..XX
...X...X....X........XXX.X..X....XXXX..XXX.X..X..X.X.X.....X....
.X...X.X..XXX...X.....X..X..X.XX.X..XX.XX..XX.XX.X...X..X....XX.
.X.....X..XX......X.X...XX....XX....XX....X......X..XX....X.....
.X..X......X...X..X..X.....X.....XX.XX.........X.....X......XX..
..X........XX..XXX...X..X....X......X..XXX...X...XXX.X......XX..
X......XX..XX.XXXX....X.X...XX.XX.X...X..XXX.....XX..X..........
..XX.X.....XX.......X.....X....XX.....X..X....X..XX...XXXXXX.XX.
..XX.....X.XX..XX......X.......XXXXX..XX...X....X...X..XXXXX.XX.
....X.XX.X...XXX..XX.X...XXXX..XXX........XX.X....X....XX..X....
.XX.X.XX.XXX.XX..XXX..XX......XXXX......X..X...X................
......X..XXX....X...X..X..X.....X...XX.....X..XX..XXXXXX....X...
XX.X....XXX.......X....XX.X..XX...X....X........X.....XX......XX
XX...XXXXXX..........XX...XX.X...XX...XXXXX.....X........XXX....
X.........XX.....X....X...XX...X....X.......X.......XX....X..X..
..XXXXX...X..X...XXXX.......X.....XXX..X.........X..X.....X....X
.X..........X........X......X..XX...XXXX.....X.X.X....X...XXX...
...XXX...X....X.X....XXX.....X......XXXXXX.....X...XXXX.X..XX.X.
X..XX....X.X..X...X..XXX...X.......X........X.XX..XXXX..XX....X.
..XX..X....X..XXXXX..XX..X..X......X....X.X.X..X..X..X...X..X...
.....XX.X..XXXXXX....X..X...X...X..XX...X......X.........X....XX
........XX...........X.X..X...X....XX.....XX.XXX.X.........X....
..XXXX...X.......XX....X.X.......X.........X.XXX.X.XXXXXX....XX.
.......X....XX...XX....X.X...X.X.....X...X.X..X....XXXX...X.X...
...XX...X...XX.X..XX.....XXX.X....XX...X....X...X...X...X.X....X
...X..X...X....XX.....X.......X....X......X...XX..X.X.X......X.X
.X...XX...........XXX...XXX.X...XX.X...........X....X......X...X
...X.....X.X....X......XXXX..X..X..X....XX...X...XX......X.....X
X....X.X.X....X..X.........X...X..XX..X....X......X.........X..X
X...XX......X....X.XX...X..X..XX...XX.........XXX..XXXXXX.X.X..X
XXX..XX...X.XXXX........X.XX.....X......XXX.X..X...XXXX...X.X..X
...X....X.X..XXXX...XX....XX.X.....X.XX..XX.XX...X....X........X
.X..XX....XX...XXXX....X...X....X....XXX....X...X..X.......X...X
..X....X...XXX....XXX....X.XX.X.X.....X...X...X...XX.X.XXXX....X
X.....XXXX...X..X.....X.....X.X.....X...X......X...X...X....X..X
X..XX........X..X..XX.....X...X..XX..........X...X.......X..X..X</walls>
			</board>