<?xml version='1.0' encoding='UTF-8'?>
<board>
				<level>153</level>
				<width>54</width>
				<height>54</height>
				<walls>X.......X..X.....XX...XXX.....XXXX..XXX...X..XXXX.....
..XX..X.X....XX.....X.....X......X..XXX...X....XX.XXX.
......X.X.XX....X......XXXX..X.X.X....X..X..XX....X...
....X...X....X.....X...XXXXX.X.....X..X..X...XX.......
.......XX...XX...X.X............XXX..XX......X.....X..
...XX..X..X...XX.X..XXX.....X.X.....XXX...XX...X.X.XXX
.XXXX.X..XX....X..X.....X...X......XXXX...X....X......
........X....X.XX....X....XX...X...X....XX..X.....XXX.
X....X.....X.....X.....X.....X...XXX.......XX...XX....
..XX.....X....XX....X..X...XXX..XXX...XXXXX...XXXX...X
......XX....X..X..X....X....XXX..X..X....X..X..X......
XXX....X..X....X..X..X......XXXX...XXXX....X........X.
..X....XXXX..X........X......XXX..XXX...X....X..X...X.
....XX..XXXX......XXX.X....X.X....X..........X....X...
........X....XX.X.....XXXX...X..X......XX......XX.....
XXXXXXX.......X.X......X....XX..X..X...XX...X...X..XX.
XXXX.....X..X...X.XXXX...XX.....XX...X..XX......XXXXX.
..XX.XX.....XX..X.XXX...XXXXX...XXXX.XX..X.X.....XX...
...X....XXX.....X..XX.X.XXXXX...X......X.X.XXXXX....XX
.X...X..........XX....X.XXXX....X.X....X....XX......XX
.X.....X.XXXX...XXX..........X....X.......X....XX...XX
....XX...XXX..X........X.....X..XXX.....XX...X.....XXX
..X.....X....XXXXX.X...X...X..X.XX..X....X.X...X.X....
..XXX.XXX.X....X...X.X..X..XX..........X...XXXXX..X...
..XXX.XXX.XXX....XX.....X.X....X...X...XX..XXX..X....X
....X.....XXX.X.....X.....X......X.X..XX.....X.....X..
..........X...X....XXXXX..XXXXX..X..X..X.XXX...XXXXXX.
.....XXXX...XXXXXX....X...X......XX..X...X....XX......
...XXX..X......XXX......X...X........X......X........X
.X...X..X......X.....X...XX...XXX.......X.X.....X..X.X
...X....X..............X.....XXX...XX.X.X..XXX.....X.X
X..XXXX.........X...XX.....X..X..X....X.XX...X.XXX...X
X..XX....X......X..........XX.X.....X.....XX......X..X
X..XX.XX.......XX.....X..X......X.............XX..XXXX
...XX.......X..X....X.X....X....XXXXXX.....X...X.XXXXX
...X......X...XX........X........XX......XXX.X........
XXX..XXX..........XX.XX...X....X....X........XX.XXX...
X...XX....XX...XX.X..X......XX................X...X..X
X.......X.XX...XX.X.XX.X.............XX.....X...X..X..
....X...X..X...XX...X......X....XX.......XX........XX.
.XX.....XX...X.....X..X.XX...XX....XXX.X.....X........
.XX..XXXXXX......X...XX.....XXXXXXXXXX....X..XXXXXXX..
..X...X.....X.XX...XX.....X......X......X...XXX...X...
X...X....X..X.....XXX........XXX.X..............X...X.
XXXXXX.X.X......X.XX.....XXX...........XXX...XXXX.....
..X..X.....X......XX.....XX..XX.X......X..XX....X..XXX
..X.......XX....XXXX....XXX...X.....X..X....XXX..X....
....XXXXXXXXXX..X....X..X...X....XX...XX......XX.XX...
...XX...X......X..XX...X..XXX..X.......X...XX....X..XX
....X...X...X....XX....X.XX....X.X...X...XXX.......XXX
XXX.XX..XX....X...X.X..X.....X.....XXX..X......XX.....
..X.....XX.X....X...XXX....X....X...XX....X.X..X..X...
........X.......XX..X...X.....X.....X..X..X...X..X....
..........X.....XX..X.....X...........XX..XX..X....X..</walls>
			</board>