<?xml version='1.0' encoding='UTF-8'?>
<board>
				<level>180</level>
				<width>63</width>
				<height>63</height>
				<walls>....X...XXXX...XXX....XXXX...X...XXX...XXX..XXX........XXXXXX..
.XX...X.XX...X.XX..XX.X....X...X.X...X......XXX..X.....XXXXXXX.
.....X..X....X....XX..X.X....XX..X.XX...X...XXXX...XX..XXXXX...
X..X...X..X..XXXXXX..X....X..X..X.....X.....X.....XX...X.....XX
...X..XX.XX.........X..X.X..XX....X.X....XX...X.X....X.X.XX..XX
.X..........X.......X.X..X.X...X..X....X....XXX.....XX.X.X.....
........X........XX...X......X......XX...X.......XX.X..X.X.....
..X...X...XX.X.....X....X.X...........X....X.X....X.X.......X..
..X.X......X....X..X......X.XXX....X....X..X...XX...XXX...X.X..
XXX.XX...X...XX...X....X.............X....XX..XXXX....X...X....
......XX..X..X......X....X.X......X......XXX.......X...XX.X..XX
...X......X.X..X...XX.X..X...XX.....X......X...XXX.X.X..X.....X
.....X....X...X..X..............XX..X...X..X.....X...XX.......X
........X.......XXXXXX....XX..X.....X.XXX.XX...X.XX...X..XXX...
...XX.X..X...X..XXXXX...X..XXXX..XX...X...XX.X...X..X........X.
......XX...X.XXXXXXX..X.XX...X...XX.......XX....X..X....XXX....
..XX...............X.......X...X.....X....X...XXX.XX....XX....X
XX...XX.....X..........X...........X.X......XXXXX.....XXX..X...
X.......X.....XXX...XXX..XX............X...XX..XX..X....X.XX...
..X.X...X....X..........XXXX...X..X.....XX.XX..XXX...X....XXX..
.XX...X.X..X.X.XXX.XXX...XX..X.X....X.X....X...X.......X....X..
....XXX......X.....XX..X.XX......X..X........X.X.XX.X.....X.X..
X...XX..XXX.......XXX.........X....X...XXXX..X...X..X.X.X.X....
....XX......X.....X.....XX..X...X....X...XXXXXX..X....X.X......
.X.....XX...X....XX.XXX.....X..XXXX.XX...X...X.....X..X....XXXX
.X.X..X...X.XX......X...X...XX.X....XX.....X...X........XX....X
.X....X...X....XX......XXXX....X.XX..X..XXXX..XX..X.........X.X
....X.X.......XX.....X..XX...XX..X...X...XXX...XX....X...XX...X
..X.X.X....XX.XX.XXXXXX..X.X..X....X...X..XX...X...X...X.......
..X.X....X.......X...XXX...XX...X..XX..XX...X....X.X......XXXX.
XX..XXXX.....X.XXX.X....X..........X....XXX.X...XX....X.X.XXX..
XX.XXXX...XX.X.X...X..X.....XX...X.X.XX.XXX.........X...X...X.X
...XXX..XX...X....XX.....X.....X...X..X...XX.........XXXXXX.X..
..XXX..X....X...X....XXX.X.XX.........XX..XX.....XXX..XXX......
X...X.....X...XX...X.......XX.XXX...XXXX.X...XXX......X...XX.XX
XXX.....X........X......X.....XX..XXXXXX...XXXXX..X.......X..XX
.....XX..X..XXX..XX...X.......XX.XX..XX.....XXXX......XX..X...X
.X....XX.XXX.....XX....XX..X.....X...X..XXX.XXX..X.XX....X....X
..XXX.XX...X.....XXXXX.....X.X.....X...XX...X...X..X...X.X.....
X...X...........XXX..X...X.....XX..XX..X..XXX.....X..X....XXXX.
......X...XXXX....X....X.XX............X...XX....XX.XXX.X......
.X......XXX....X....X.......X............X.X.........X..X..XXXX
.X........X..XX..X......X.X..........XX....X.X.....X...X....X..
.X.....XX.XX..X....X.XX...X......X...XX...X....XXXXXXX...XX....
.X...X....XXX.....X..XXX.......X.....XX.....X...XXXX.....X...X.
...XXXXX...XXXX.....XX.....X.X....X..XXXXX..XXX..X...XX....X.X.
....XX...X......XX...........XX...XXXXXXX...XXXX.....X..XX...X.
..X......XX....XXXXXXXX...XXXXX.......XX..X.......X..X...X.....
X.....X..X..X........X..X........X.....X...X....X......X......X
X..XX...X..X..X.XXX..X.........X.X.X.X.....X.XX.X...........X..
..........XX.XX.....X......XX..X...X....XX...XX.......X........
.XXX...XXXXX.XX...XX..XXXXX...X...XXXXX..X...XX..X.XX..........
.....X..........X....XXX........X......X......X....X...X.......
..X...................X....X...XX..XXX.XX...X...XX...X.....XXX.
XXX..........XXX....X...X....X..X..X...XX...X..XXX......X..XXX.
XXXX......X..XX..X........XX....XX....XX..X..XX...........XXXX.
........X.XXXX..XX.X.....XXX.....X..X..X.....XX...X..XXX....X..
....X.X...XXX..X.......X.....XXX....XX...XX...XX..X..X...X....X
....X.......X.X.....XX....X....XXXX..X......X....XXXXX.X...XXXX
...XX..X......X.X...XX..X...X..X.....X..XX....XXXXXX...X..XXX..
....X...XX......XXX.....X..XX.X..XXX..X....XX.....XX.XXX..XX...
..X...X......X......X.XXX.....X.......X.....X..XX..X...X.....X.
XXX..XX..XXX...XXXX...XXX.............X.....X..XXX.....X.......</walls>
			</board>