<?xml version='1.0' encoding='UTF-8'?>
<board>
				<level>157</level>
				<width>56</width>
				<height>55</height>
				<walls>...XXXX.....XXX...XXXX..X.......XXXXXX..X.........X.....
.X.......XX.X...X.X.....X.....X.XXX.....X...X...X.....X.
.......X..X.....X...X...XX....X.......X.XXX...X.XX.X..X.
X.XXXXXXX.XX.......X....XX.X.....X.X....XXXXX...XX.X.X..
X.XXXXXX.......X.....XX....X.......X.X...X......XX.....X
..XXX....X.......XX.X...X.......X......X...X....X.....XX
...X..X..XXXXXX..XX...XXX...X.......XX.XX..XXX....XX...X
XX...XX..XX..XX...........X....XX...XX.XX..XX....X.....X
..X..XX..XX.......XXXX.......X....X..X.XXXX...X.....X..X
.....X...X..XXXXX...X....X.XXX.X..XX...X....X...XXX....X
...X.X...X....X...X.X.X....XXX.X....X..X..........XXXX..
.....XXXX..XX.....X...X.....XX.XXX.....XXXXXXX......X...
XXX.......................X....XX..XX..XXXX...XX.X....XX
XX..XX......X......XX..X........X.....XXXXX.X....X.X.X..
XX.XX..XX.X......X.X...X.X.XXXX...XX..X..XX.X..XXX.X....
...X..XXX....X...X...X.....XX.....X...X.....X..XXX....X.
.XXX.XXXXXXX...XX..XX...XXXX........X.X......X...XXXX...
.XXX............X...X........X...XX.....XXXX...X....X..X
...XX......XXXX...X.....XXX....XXX......XX.......XX.X...
XX..X.XXXX...XX..X...XX.XXX...XX...X.......XXXX..XX.....
....X.XXX....X..XX.X..X...X...X....XXX.XX...XX..X....XXX
........X.X....XXX....XX....X...X....X....X....X..XXX...
XXXX......X.XXXXX...XXX..X...X....XX...X..XXX....XX...X.
XXX....X..........X...X.X..X.....XX........X..X.......X.
..X......X.XX...XXXX....X.X...X.....X.X....X......XX....
.....XX..X....X......X.X..X.X......XX.....X..X.......X..
...X....X.........X..X.X.XX....XXX...X.XX.X......X......
...X..X...XXXXXX..X..X.X....XXX...X..X........XX........
.XXX...X...X.....XXXXX....X..XX...X.X....XXXXXX...XX....
.....X...X.....XX..X....X.XX..X..XX...XX........X..X.XX.
XXX..XX.....XX..X....XX.X...X.X........X.......XXX......
XX......X....XX...X..XX...X.....X......X..X....XX..XX.XX
XX....X....X.....X...XX......X......X..X.....XXXX..XX.XX
...XX....X.....X...X.......X...X.....XXX...X...XX...X..X
.......XXXXX......X....X......XX...X.....X.....X..X....X
..X.....XX...XX.X...XX......X.XX.X..X....X.XX....XX.....
......X.XX......X..X...........X....X.X..X..X...........
...X....X...X...XX....XXXXXX.X....X...X..XX..XXXXX.XXXXX
.....X....X...X.XX..X.XXX....XXX......XXXXXX.......X....
XXX....X........X...X.XXX......X.X....XXXXXX..XXX....XX.
XX..XX.....X......X.....X....X.......XXX..XX..X....XXX..
...XXX..............XX....XX....XX.....X...X.....X..X..X
.X.......XX.XX.........XX.....X....XX....X...X...XX.X...
...XX.X.....X..X...XXXX...X...X...XX..X.....XXXX......X.
X..X..X.X.X...XX.XXXX.......X.XXX....XX........XXX......
X..X......X...XX.X....XX......X..XXX..XX.....X.....X...X
X......X......X..X......XX.......XX...XX...X....XX...XXX
..XX...XXX....X.XXX......X.....X....X...............XX..
.X...XXXX.....X...X....X...X...XXX....X.....X..XX.......
.....XXXX.XXX.XXX....XXXX......XX......XX.....XXX.......
XXX.....X.....XX...X...XX...X..X..X..X.........X..XXXXXX
X...XXX....X.....X...X.XXX.....X.....X..X....X.X...XX...
..X...X..X...XX..X.....XX..X.........X....XXXX.....XX.X.
....X....X..X....X..XXXX..X.....XX...X....XXXX........X.
XX..XXXX......XX.........XX........X......XXXX..........</walls>
			</board>