<?xml version='1.0' encoding='UTF-8'?>
<board>
				<level>166</level>
				<width>59</width>
				<height>58</height>
				<walls>XXXXXX..X.........X......X...XXX....X...X..XX...X.....XX..X
........X.........X....X.X.X.....XX...X....X..X.X..XX.....X
......X..XX...X...XX.....X....X..X....XXXX...XX.XX........X
X.....XX.X..X.X.X....XX.....X.X..X....XXXXX..X..X...XX.....
X.XX..X..X.XX.......XXXXX................X...X....X........
..X...X.......XX.XX...XXX....X....XXXXXX.X...XXX....X.X....
.XX.........X....XX.....X.XX......X....X.......X......X.XX.
.X.....XXXX....XXXX..XX...X..XX...X.XX.X..X..X.XXX.........
.X.XXXX...X.XX..X.....X.....XXXXX...X..XX....X.XX..XXX...XX
.X......X...XXX....XX....X..XXXXXX..X...X.XX...XX....XXX..X
....XX....XXXX...X.X...X..........XXXXX.....XXXXX.XX...XX..
XX....XX.....X.......X....XXX........X...XX....X..X....X...
...X.....XXX.XX...X.......X...XX...X...X.....X...XX.X....XX
.XX..XXXX..X..X.X.....X.X.....X..XXXX.....XX.XXX......X....
.XX...XX...XX...X..XX.X.X.XX..X.......X.X..X..XX.X...XX.XX.
....X....X..X..XXX....X.X.XX.......X..X..X.XX......X....XX.
X.....X..XX..XXXX..X..X.....XX.XXX...X...X........X..X..XX.
..XX....XX...X....XX........XX.XXX.....XXX..XXX...X.XX..X..
.X...XX....XXX...X...X.........X....X...XXXXXXX.X.X.X.....X
.X.X........XXXX...X.X...X........XXX.X.X.......X...X.X....
...X...XXXX...XX..XX...X......X...XX....X......XXX..X......
..XXXX.X......XXX..XX...XX....X...X..X.......X.X...X...X...
...X.....XX........XX.X.X..X..XXX...X......X.....X...X...X.
...X..X...X.....XX..X.X.X.XX..X....XX.XXX.......XXX....XX..
XXXXX.....XXXXX.....X.X.X.X.....X.....X.....X...XX..X.....X
.......X.........X....X...X.XXXXX.X......XX..XX....X..X...X
.....XXX..X..XXX...X......X..XXXX......X..XX......XX....X..
X....XXXX.X.......XX...X..XX..XXXX.....XX..X..X.....XX...X.
..XX..X.....X........X...X..X.X..X.XXXX....X..X..X.....X...
.XXXX....XX...XX...X.XXXXX..X....X...X..X..XXX...X.X.XX...X
......XX..X...XX...............X.XXX...X...X...X...X....X..
..X.....X.....XX....XX.....XXX...X..XXXX.X.............X...
X.......XXXX.....X.......X..XXX...X.......X...X.....XX...XX
..XX.......XXX.XX..XX.X.....X...X.X.....X...X...X...XX..XXX
.XXX...XX..XXX....X...X.X.......X.X...X..X........X.....XXX
.....X....XXXX...XX.....XXXXXX..X...XXXX...X.......XX.....X
XX...X.X....XX.X.XXX...XXXXX...X...XX.....X..XXX.X.X......X
XX.X.X.X.....X.X...X.X...XXX.X...X.XX.....X....X.....X.....
.....X.X...X...XXX...X.....X.X..XX.XX...XX..X.....XX....XX.
.XX......X..XX..XXXX....XX.X........X.X....XX.X.......X....
...XX.......XX..X.....X....XX.....X...X..X.......XXXX....XX
XX....X.........X...X...X..X..XXXXXXXXX..X.X...X.XX....X..X
......XXXXXXX...X......XXXXX....X...XXX......X......X..XX.X
..X..XX..XXX..X......X..XX......X.X.X...X.XX....XXX...XX..X
X.X...X....X.....X.X..X.XX........X...XXX..XX..X......XX...
....X.X.XX...XXX.X....X......XXX...X..XX...X...X...X..X....
.X......XX..XXXX......XX.....XX..X...X...XXX.X..XX.X....XXX
.....XXX.....XXX..XX..XX...XXX..X......X........XX.XXX...XX
..XXX....XXX...X..X...XXXX...X....X.XX.....XX......XX....XX
XXX.....XX.....XX...X.........XX..X.....XX.XXXX...XXX......
...........X...XX.XX.....XX.X.XX.....XX..X....X.X...XXXXXX.
...X.....X...X..X.XX.XXX.XX....X...X.....XXXX...XX......XX.
....XX......XXX...XX...X.....X.....XXX....XXXX.....X.XX....
..X.....X.X....X..X....X..X.....XX..XX.XX.XX...XX....XX..XX
..X..XX.X....X...XX.XXXXXXX...X.X...X..XX.........X.......X
..XX.......XXX....X.....XXXXX.X...X...XX...XX...X.XXXX..X..
...X...X.....X..X....XX....XX......X...X.X....X....XXX...X.
...XXX.......X..X..X.......XX..XXX...X...X..X....X.....X...</walls>
			</board>