<?xml version='1.0' encoding='UTF-8'?>
<board>
				<level>94</level>
				<width>35</width>
				<height>34</height>
				<walls>...XX....X......XX.........XXX....X
.X.X..XX.X...XX......X...X..XX.XX..
.X...X...XX..X..X.X..X.X.XX......X.
...XXX....X.XX....X.X..X.X.........
...X....X......XX.....XX...X......X
.....X..XXXX....X..X......XX.XX.X..
..XX...XX...XXX....X..XXX..X.XX....
XXXX......X..XXX...XX....X......XX.
......X...XX...X...XXX...XX...X.XX.
....X...X.XXXX...X.....XXX..X.X..X.
X....XXXX..X........X.........XX...
...X.....X......XX..X.X........X..X
.X..X....XXXX...X..XX...XX...X.XXXX
..X.X.X..XXX..X...XX....X..X.X....X
X.X.X.X....X.....XX..XX...XX......X
....X..........X.XX.XXXXX..X..XXX..
.X...X......X.......X...X..XX......
...X........X...X.X...X....XX....X.
XX....X...XXX.....X...XXXX..XX...X.
XXXXX.X...XXX..X..........X..X..XX.
..........XXX.....XX.XX......XX.X..
.....X.....XX...X....X..XX......X.X
XX.........XX......X...XX....X....X
XX....X....XX....X.....XX.X....X.XX
........XX.XXX.....XX.....X.XX.X...
..X..X..XX............XX..X......X.
X...XX...X...XX.....X.....XXX....X.
....X..X.X.X.X....XX..X...X........
.X..X......X...X.....XXXX...XX....X
.X......X.....XX.XX....XXX..XX..X..
...X...X....X..X.XX.....X..........
.....X...X...X......X.X...XXX......
....X...XX......XXX.X..X...XX.XXXXX
..X...X....XX.......XX...X....XXXXX</walls>
			</board>