<?xml version='1.0' encoding='UTF-8'?>
<board>
				<level>151</level>
				<width>54</width>
				<height>53</height>
				<walls>XXX....XX...XX.............X.....XXXX....X..XX.....X..
XXX.XX....X....X.....XX....X.XXX.XX...XX....XX..XX....
..X.....XXXX...X...X.XX.X..X..X..XX.....X...XXX...X...
......XXX..X.X.X...X....X..XX.X.XX..........X......XX.
...XXX.....X.X.X.....X..........XX.X...........X.X....
........XX...X....X..XXX....XX...............X...XX...
XXXXX.X..XX....XX.X.XXXXXXX.X.....X....XXX......X...X.
..XX..XX.XX.....X......XXXX...XX....XX.XXX..X.X.......
...X........X.X....X...XXXXX.....X...X.XXXX.X.X..X...X
.X......XXX...XXXXXX...XXX...XX....X...X......XX...X..
.........XXX...........XX.........X......X...XX.......
X...XXXX...X........X.....X.X.....X..XX..XXX.X..X.XXXX
..X.XX.....X..XXX........XX...X...XX....XX...X.XX...XX
.......XXXXXX.....XX...X...XXXXXX...X...X..XX..X..X...
XX...X...XXX..XX..XXXXXX............X...X...X.XX......
X..X...X.XXX.XXX..XXXXXX..X.....X........XX...X..XXXXX
..X..X...X...XXXXXXXXXXX..X...X...XX...X.X....X.....XX
....X........XXXX.........XXX.....XXXX.....XX.....X.XX
XXX...X.X....XXXX.X.......XXXX....XXXXX...X....XX.X...
....XXX...........X...XXXX.....X..X.....X...XX..X...X.
...XX.......XX....XXX......XXXX...X.XXX...XX....XX....
....X.......XX..X........XXXX...X...X........X...X.X.X
..X...XXXXX..XX......X......X..........X.......X.X.X.X
..XX...X.....XX..X...X..X.....XX.....X.X....X..X.....X
X....X...XXX...X...XXXXX...XX....XXXXX...X.....XX.X...
X.XXX...XX...X......XXX..X...X....XX.......X.X.XX...X.
X.....X.XX.X......X.....XXXX...XX.XX.......X..........
XXX........XXXXXX....X..X..XX..XX.XXX.........X......X
XXX....X......XXX.......X......X..X...X.....X......X..
XXXXXX......X.........X.X......X....XX..X........X.XX.
........XXX.XXXXXX......X.....X......X....XX........X.
.XX...X.XXX.X.....XX...XX.X.....X......XX.........X...
....X...XX..X.XXX.X.....X....X.X....X...X..XXXXX..XX..
..XXX......X....X...X.X....X...X.X....X.X...X..X..XX..
XX....XX..XX.XX...XXX..X....XX.....XX.X...X....X..X...
X..XXXXX.....XXX....XX....X.....XX.........XXX....X.X.
X.XXX..X.........X..XXX.X..XXXX....X.XXXXX...XX...X...
....X...XXXXXXX..X......XX....XXX..X..XXXXX....XX....X
.X....X...X...X....X.....X..X......XX..X....X......X..
...XXX......X...X....XXX..X..........X.X..XX..X....XX.
.......X...XXXX...X..XX...X.....X....X.XX.X..XX.X.....
..X..XXX....XX......XXX.........XXX....XX...X.....X.XX
X.X......XX....X........XXXX........X...XXXX...X..X...
X...XXXX....X......XX..........X......X......X...X....
XX....XXX.....X....XX.XX.XXXXX....XX..XXXXX.....XX.XXX
XX.XX.X..........X.....X....X...X.XX..XXX...XX.....X..
XX....X..X.....X.....X...XX...X.....XXXX..XX...X......
....XXXX...X.XXXXXX......XXX.....X....X..X...XXXXXX...
.XX..X.....X......X.X.....X....X...XX...X........X..X.
...X..........XXX.....X.X...X........X....X......X....
....XXX...XXX......XX...X..XX...XXXX...X....X...X..XXX
..X.....X...X.......X......XX....X...XXX......X.X.....
..X..XX.....X.......X....XXXX..X...X.......XXXX.......</walls>
			</board>