<?xml version='1.0' encoding='UTF-8'?>
<board>
				<level>267</level>
				<width>92</width>
				<height>92</height>
				<walls>.......XXXXX..XXX..XXX..XX.....X.....X...X..XXX.....X..X.....X...XXXXXX...X..XXXXXXX..X....X
....XX.X......X....X....XX.XXX.....X...X.X..X.....X....X..XX.X.X..X.....X....XXXXXXX..X....X
XX..XX......X......X..X......XX.XX.XX..X....X.XX.....X..X..X...XX.......XX...X........XX...X
...X....XX.........XX...X.X..X..XX..XXXXXXX......XX.....XX....XX...X....X..X.......XX....X..
.XXX.......X.......XXXX...X.XX....X........X.X......X....X..X..X.....X..X.....X........XX...
....XX..X........X..X....XX.X...X....XXXX....X..XX.......X..XX...XX..X....X.....X...X..X..XX
..X..X...XX.X.......X.XX..X.X.X...........X...X.X..X.....XX......XX..X...XX...XX..X...XX...X
...X.X.X..X.....X.......X.....XXXXX......XXXX.X...X..X...XX.X.....X....X..XXX.XX....XX...X..
...X...XX....XX....X.......X...XX....XX..XXXX....X..XX...XX.....X.XXX...X.......XX..X..X....
X...XXX....X.....X...X...X...X.XX..XX...XXXX...X...XX....X...XX...XX..X.XXXX........X...XX..
X.X...X..X.....X..XX...XXX.....X...XX..XX....X.XX.....X....X.....XXX.....XXX.....XX.....X...
......XX.XX.....X.....XXXX..X....X.XXX..X.X....XXXX.X...X......X.......X....XX...XXX...XX.X.
.X.....X.X....X.X...X..XX.....X....X..X.X........XX.X...XXX.XX....XXXXX...X....XX....X..X.X.
...XXX.....XXXX...X..X....XX..X...XX..X.XX.X......X.....XXX.......X.....X............XX.....
XX......X....XX....X.........X....X...X..X......X....X..X...X..........XXX....XX.X.......X.X
XXXXXX....XX....XX.X..XXXX...X.X....X.XX.XX........X....X.X.X........X.XX..XX.XX....X....X..
.......X...XXX..X..X.........X...X..X..X...XX....X..X.....X.....X.......X...X.......X.X.....
...XX....X......X.....XXX....XXXXX..XX.....X..X.....X.XX.....X....XXX.X.....XXX.......XXX.XX
....XXX...X.........X.....X..XX....X.........XX.X.....X....XX..X......X.......X.XXXX..XXX..X
..X.....X...XXXX.XXXXXX.....XXX.X..X......XX....X....XX.XXX...X..X...XX.....X............X.X
XXXX....XX..XXXX.....XX..XX.XXX...X...XXX....XXXXXX.....X...XXX....X...X.......XXX..XX.....X
.......XXX..X........X...XX......XX.X..XXXX......X..XX.........XX....X....XX....X...XX..X...
....X....X..X.XXX......X..XX.....X..XX......X......XXX.X...XX....XX.....X.....X...X..XX...X.
..X...XX...XX........XXXX..........X..........X...XX...X...X..X...X.XX.....XX......X...X....
..XXX...XX.X.......X......X.....X......XXXXX..X...X....X...X.X..X...X..X.XXX...XXX.....X.X.X
X...X.X......XXXXX....X...XXX...X.X....XX.......X...X....X.....X......XX.....X....XX.......X
..X.....XXX.........X....XXX....X...X...X.XXXXX....X..X..XX...X..XXX.........XXXX.......XX..
.XXX....XXXXXXXXX.X....X.X...XXXXX....X...X....XX....XX.XXXXX...XXX....X.....XXXXXX.X...XX..
.....X......XX....X..X...X....XXXX.X.XX......X....X.....X..X........XXX...........X...X.....
XXX....XX......XXXXX.....XXXX...X....XX.XX.X.X...X......X....XXXX...X...X...X...........X...
....X.X...XX.X...X...XX..XXX..X...X.....X..X...X...XX.....XXXXX...X.....XXX.................
.X..X....XX..X.X........XXXX.........X..X..................XX...............XX....XXXX...XXX
...X...X.XX.......X...X........XXXXX......X....XX....X..XX....XX...XXXXXX......X....XX......
X..X.........XX.X...X..X.....XXX............X.....X..XXXXXXX..X..X...X.....X.....XX..X....X.
..X...X...X..X..XXX....X...X.XXX....X....X....X.....XX...XX...X....X...X...X.XX.XXXX...XX...
.XX.X...XXX.XX.X....XX..X....X....X...XX.X...XX.XX...X.X.XX...X.XX.XX...XX.X.X..X..X.......X
....X..........X.X....X...X.....XXXX...X...XXXX.X..X.X........X.XX.XX.X..X.....XX..X.....X.X
......XX...X...........X..XXXXX...XX.X.XX.......X.......X.....X.......XX......X....X..X....X
.........X......X.X..X......XX....XX.X.X.......X..X...X....X....X.XX...XX...X...XX.X..X.X.XX
..X..X..XXXXX...X....X..X...X..XX......X.X.....X....X....X.XXX..X....X....X......X.XX...X...
XXX..X..X..........X.X..X.....XXX...X....X..X..X.....X...X...X...........XXX...X.X.......XX.
.....X..X..X.......X.X.........XXXX...XXXX....XX...X..XX..XX...XXXXX...X.....X.........X....
.XXX....XX.X......X..X...X..XX.X......X....XX..X....X.....X.....XX...X.X..XX..X...XXXXX...XX
.XX.....XX...X......XX.....XX..X...X....XXXXXX...XX..XX.....XXX....XXX......X.X...X.....X...
..X.....XXXX.....XX.....XX..X........XXXXXX......XXX..X....XXXX...X...X..XX.....X......X....
X.X...X.......XX....X....XX..XXXX...........X.....XXX..X...XXX..X.X.X..XXX...XX......X...XXX
..X.X.......X.X..X..XXXX..XX......XXX......XX...X......X...XXX......XX...X....X...........XX
.XX.X..X......X.XX..X..XX.....X.....X.X.......X..............XXX.X...XX.......X.XXXXX...X.XX
..X....X..XX.....X..X...XX..X.X..X....X.X...X.XX......XXX........X.X..X.X.......XX....X.X.XX
X....XXXX......X....X.X..X....XX...X......X......XX.......X...X.....X...X......XXX......X.XX
...XX......XXXXX..X...XX...XX..X.......X...X...XXXX..X.XX...XXX.X.X.......X.........XX....XX
.X..X...XX....XX..X..X......X..X.XX.XX.X.X...XX..XXX...XXX......X....XX..XX.X...X......X...X
..X..XX.....X.....X.....XXX....X..X....X.X............XX...XX..X...X..X..XX..XX....X.....X.X
X....XXXXXX....XX...X.X....XXX..X.XXX....X.XXX.....XX.....XXX....X.XX.XX...X.....X....X..X.X
X.......X....X.XXX..X.XX.....XX...XXX...XX.XX....X...XX.X.....XXX..XX....X.XX.......X.X..X..
X.....X...XX.....X..X.XX..X...........X....X..X.........XX...X....XX..X..X................X.
XXX...XX......XX....X...X...XXXXX.........XX.XX.X...X......X...X........XXXX.XX......X....X.
......XX...X......X.....X......XX...XX.XX....XX.X.XXX.XXX.....XX.X...XX...X..X..X.XXXX...XX.
...X.....X......X....XX...XXXX.XXX..XX.XX..XXX....X.......X...X..X.X...XX...XX.XX.XXXXXX....
X....X.XXX..XX.....X......X....X...X...XXXX....X.....XX...X..XX......X...X.....XX.X....XX...
X.X....X....XX.X.XX..X......X.....X..X........XX...X..X.X..X....X......X...XX...X...XX.X..X.
....X....XX......X..X....X......X.X........X.....X.XX......X..X...X.XX........X.....XX...XX.
.X....XXXX....X....XX......X.X..X...X......X...X...X...X......XX....XX......XX...XX...X...X.
.XXX.......X...........XX..X....X....XX......XX..XX..X......X....X...X....X....X..XXX...X.X.
.XX..XX......X......XX..X..XX...X..X.XX...X..X..XXX.....XX....X....X..X...XXX..XX...XX......
.XX........XXXXXXXX.XXX.X..X..X..XX.....X....X.XX..XX...X..X..X.....X....XXX...XXXX....X...X
.......XX....XXXXX..X......X.....X..X.XXX.XX.X..X.....X...XXXXX...X....X...X...XXXXXX...XX.X
X..XX.....X...XXX..X...X.....XXX...X..XXX.XX..X.X...............X...............XXXX..X....X
...X..XX....X.....XX.X...XX.X......X......XXX.......XX.....X.....X...XX.....X.....XX.....X..
.X...XXX...XXX...X.......XX.X.XXX..XXX...XXX...X...........X.X.X.X.X.XX.....X.XX..X....X....
....X....X.....X....X.XX..X...X....X...X...X.....X...XXXXXX....X.X.X....X......X....XX.XX...
XX....XXX..XX.....X.X..XX.XX....X..X.X......XXX..XXX..XX....X......XXXX......X.X............
...X......XXXXX.....XX.........XX.XX......X.....XX..X....X......XX..................X.X.....
..X...XX....X....X..X...XX.....XX.X..XX.X....XX.XX..XXX..X...XX.......XX..X...X.X.....X.XXX.
..X.X.X..XX.X......X..X.X...XX....X.....X.XX..X..X....X..XXX....X...X.XX..X.X...X..X....XXX.
......X...X...X.X....XX...X....X..X...XX....X..X...XX.XXXXX......XX....X....X..XXX....XX....
.X...X....XX....X.X...X..XXXX....XX...XX.X.....X....X.XX....XXXX.....X...X.......XXXX.XX.XXX
.XXX...X.....X..X.....X..X....X...X........X..XX....X.XX.....X....X............X...XX....X..
..XX..XX.XX..X..X..X..X..X...X..X.......XX....XXX..........X...XX.........X........XXX......
X.....XX...XX..XXX....XXXXXX...XXX..X......XX..........XX..XX...XX.X..X.....X...XXXXXX.XX...
X..XX...X..X...X...XX...XX..XXXX....X.XXX..XXXXX.X...X....XX..X.XX....X.XX..XXX...XX...XXXX.
...XXXX...X..X....X.....XX..XXX.....X...X......X...X...X..XX..........X.XX..X...X....XXXX...
.X.XXX..XX..X...X...X.......X...X...XXX...X........XX.....X....X......X.....X...XXX.......XX
.X.X....XX.XX......XX...X...X.XXX...X....XX.X.X.......X...X.XX.....XX..XX...X..XXX..X.....XX
...X.XX..X.......X...X......X.....X....X......X.XXX.X.....X...XX...X...X....X....X.X..XXX..X
.....XXX.XX..XXX.....X.X....XX.......X.....X........X..XX...X....XX..X...X..X.XX...X.XX..X.X
..X....X.....X....X....XXXX....X........XX.....XX...X..XX...XXX...X.........X...XX...XX....X
X..........X...XX...X..XXX....X......XX...........X.XXX.........X...X.....X.XXX......XX.....
...X....XX...XX..X..X..XXX.X....X..............X..X...X....XXX...XX...X...X....XXXX..XX.....
.X....X......XX....XX....X...X.....XX............XXXX........X.X.X....XXX.XX.....X....X.XXXX
...XX.....X.....XX..X.....X...XX.X..X...X...XXX....X...X...X.....X.X...XX.....X....XX.X...XX
XX.....XX...XXXXXXX.....X...X....XX...X...X.....XX...X...X......XX...X......X...XXXXX.....XX</walls>
			</board>