<?xml version='1.0' encoding='UTF-8'?>
<board>
				<level>161</level>
				<width>58</width>
				<height>56</height>
				<walls>.......XX..XXXX..........XX..XXXXXX.........X..X...XXXXXXX
....XX.....XX.......X..X.X...X....X..XX...X....X.X.XXXXXXX
..X......X..X....X..X..X...X......XX....X...XX...X.XXXX...
XXX..XX..XX....X...XX.....X...X...XXX........XX..X.X......
XXXXX...XX...X.X.XXX..XXX.X.....X.......XX.X..X....X.X.X..
...........X.X.X.XX..XX......X.......X..X..XX...X....X.X..
.....X...X.....X....XXX.XX.X.....X.....X..X..X.......X....
..X....X....X...XX......XX....XX.....XXX.......X.....XX...
..X.X.....X...X.XX.....X....X.....X....XXX....X.....XX....
......X......XX.....X....X....X.X...X..XXX......XXX.XX.XXX
.X.X....XX.X.X....XXX.X....X..X.X..X..XXXXXX...X..X..X..XX
...X...XXX.....XX...............X..X.X.......X....XX....XX
..XXXX....X.XX....XXXX...........XXX...X...X...XX..X..XX..
XXX...XX....X..X...X.....XXXXXXX.XXXXXX..X.......X.XXX....
....X....X....X..X...X...XXXX..X...X....X..XX......X......
...XX..XX..X..X...X........XX......X.XXXX.......XX........
...XX...X..XXX..X....XX.......XXX.........XXXXXX...XX.....
......X.X..........X....X...X.....X.X...X.............X...
..XX....X.X....XX...X...X.XXX..X..X...X.......X...XX....X.
XXXX...XX....X....X.....X..XXX.X...........X......XX.X....
...XXX.X...X.....XX..X.....XX....X.....XXX...X.X.......XXX
.....X...XX....X.XX....X......X......X.........X....X...XX
..X......X..XX.X..X.XX..........X..X.XXXX...X..X..X...X..X
....XX...X...X..X...X...X......X...X...XXXX....XXXXX.....X
.X...X..X....XX....XX.X...XX.....X...........X.....X.X....
...X.XX...X...XXXX....XX....XXX.....X.X..XXX....XX.X......
X..X...X....X.X.....XXXX.XX..X..XXX...X..XXX..X..X....XXXX
...XXX...X....X..XX....X..XX...XXXXX.....XX...XX..XXX..XXX
...XX......X...X...X...XX..XX......X.XXX....X...X....X.XXX
XXXXX..........XX..X.XXXXX.......X.X.......X..X..X...X...X
...XX...X...XX....XX.XXXX....XX....XXXX....X.....X..X....X
.X.X..X...X....X..XX...XX.X.....X...X...X..X......X...XX..
.....XXX....X..X....XX....X..X....X........XXXXXX....X....
X........X.......XX.....XXXX...X.....X...X.XXX.....XXX.XX.
.....XX....X.........XX.XXXX.....XXX.XXX...XXX.X.......X..
.....XX.X....X....XX..X....X..XXXXXX.XXXX..X...X......XX.X
....XXX.X.X....X......XX...XXXXX..XX......X..XXX..X...X..X
.XX...X.....X....X.....X..XXX..X...XXX....X...XXX.....X...
.........X....X.....XX..X...X....X...X........X....X..XXX.
...X...X...X....X.X.X...XX....XX..X..XXX...XX....X.XXX....
.X...X.....X.XX...X...X..X.X...X..X.XXXXXX.....X...X...XXX
....X......X..XX.........X..XX....X.XXXXX....X..X..X.....X
..X...X.......XX.......X..X...X...X....XX.....X.X........X
......X.....XXXXX...X.....X.......XXX..X....X....XX.......
...X..X...XXX.....X.X.X......XXXXX....X..XX....X.X...XXXX.
.....XX....XX..X..X.....XX.X..XXXX...XX............X......
XXX......X...X.X.....X...X....XXXX...XX...XXXXX...XX..XXXX
......XX...X...XXX.X.X.X..X...X..X....X.X....X..X..X......
.XXX..XX......XXX..X...XX.....X..X..X...X..X.X...X...X.X..
.XXXX.......X...X...X......XXX...X..X..X.......X.X.....X.X
.XX...X.....X....XX...XX.X...X.X.X..X.....X...........X..X
......XXX......X..XX.....X.X.....XX.....X.........X..XX.XX
XX........XX....X...XX......X...XX...X.....XXX.....XX.....
..XX.X....XX....XXX....XX.X.X...XX.X...X...XXX.....X...XX.
.....X.X..X..X...XX..X....X.XXX.X........XXXX...X....X.XX.
.......X..X....X............XXX...X...........X...X..X....</walls>
			</board>