<?xml version='1.0' encoding='UTF-8'?>
<board>
				<level>62</level>
				<width>25</width>
				<height>23</height>
				<walls>..XXX..X.........X.......
....X....XXX.......X.....
.X....XX.....XX.........X
.X.X......XXXX......X....
.X...XX.X......XXXX....X.
.XXX.X..XX....X...X.XX...
.......X...XX...X........
...XX....XXXXX.....X.....
.X...XX.....XXXX.X.X..XXX
.XX..X..X......X...X.....
.X..X..XX.XX.X..X..X...X.
...X..XXX.X..XX.X....X...
X....X..X...XXX...XXX....
..XX.......X...XXXXX..X..
.....XX..X...X.....X..X..
XXX..X..XXX.....X........
XX.....X....X.X...X....X.
...XXXXX.X..X.......XX...
.....X......XX...........
XXXX....X..........X.....
..X...X......X...X...XX..
....XX...XX....X.....X...
.......X....X..XXXX..X...</walls>
			</board>