<?xml version='1.0' encoding='UTF-8'?>
<board>
				<level>87</level>
				<width>32</width>
				<height>32</height>
				<walls>...XXXXXXX..X.....X.........X...
.X..XX......X.XXX.X.......X...X.
..X....XXXX.......X..XXX........
X...X..XX......X...XX....X.....X
..........X......X....X......X..
.X..........XX..XX......X.XX....
.X..X........X...X...XX.X..XXXXX
.X....X....X...X...X..X.XX...XXX
...X.......X..XX......X...XX.XXX
..XX...X...X..X....X.......X.XXX
XXXXXX.XXX.XXX..X....X...X...X..
XXXX.....X...X.XXXX....X....X...
..........XX..............XXX.X.
....X...X.X...X.X.....XX......X.
XXX...X.....X.X....XX.XX....XX..
......XX...XX....X..X...XXX....X
...X...X....X..XXXX.XXX......X..
.....X....X.....X...XX.....X....
..X...XXX....XX.....X..X........
XXX.X........X...X..X.....X.....
XXX......X..X..X....XXX.X....XX.
XXXXXX...X....XXXXX.....X..X.X..
X..........X.............X.....X
......X...XX.XX...XXXXXX....X...
.X.X..XXX.XX....X....X....X.....
...X.XXX..X...XXX..X...X.....XXX
X......X....X..XX.........XX...X
..X.XX.......X....X.....X.XXXX..
.XX.....XXXX...X..X.XXX.....XXX.
....X...XX.....X....XXX......XX.
..X.XXX.....X....X.........X..X.
..X.......X...XX.........XXXX...</walls>
			</board>