<?xml version='1.0' encoding='UTF-8'?>
<board>
				<level>140</level>
				<width>51</width>
				<height>49</height>
				<walls>.......X...XXX.........XXXX...X...X....XXXX..XX....
.XXXXX...X..XX.....X.....X..X...X.X.XX....X.....XX.
........XXX..X..XX.........XX.....X.XXX.....XXXX...
......X....X.X......X.....XX..XX....X....XX..X....X
.X....XXXX.....X......X......XX..X.......X...X..X..
.....XXX....X....X....X.......X....XXX...X.X....XX.
..X...XX......XXXX....X.XXXX....X......X...XXXX....
....X......X..........X..XXX.X....X....XX..XXX.....
.XX..........X....X......X.....X.....X...X..XX.....
....XX....X.XX.XX......X....X....X.X...X....X......
..XXXX.XX...X..X..XX......X...X..X.X...XX...X..X...
..X....XXX....XX...X....X....X...X........X.XX...X.
....X........XX..X...X.....X...X.XX.....X.X...XXX..
................XX.....X...X..XX.XX...XXX...X..XX.X
XXXX.X......X....X.XX....X.XXX....XXX.......XX.....
..XX...XX.....XX......XX.X...X..X.XX.....X.......X.
..X....X..XX...XX...X.....XX....X....XX....XXXX....
....X..X.....X....X...X.X.XXXXX..X...XX.X.......X..
...XX.X..X....X...XX....X......X...X.........X....X
....X.X.....X........X...X......X....X...XXX...XX.X
XXX.X..XX.X..X.........X......X...X....XXXX...X...X
X...XX....XX..XX....X...XXX...XX....X.......X...XXX
X....X.....XX...XX....X.X...X.XX.X.......X.........
...X...XXX.XX......X......X.X..X.....XXX.XXX.XXX...
.X.XX...XX.......XXX.X...XX....X..XXXX.....X.......
.X....X....X...XXXXX.X...XXX..................X....
.X..XXXX...XXX..XX...X....XX.XX.....X.......X......
.X..X....XXXXXX.....XXXXX.......X...X.....XXXXX....
.X....X.........X.X...X.....X.....XXXXX.X.....X.XXX
.X.X..X...XX......XX....XXX......X..XX..X...X......
...X..X.X....X...X...X.......X...X.....XXX.....X...
XXX.....X.XXXXXX....XXXXXXXX....X..X....XX.X.......
XX..X.............X...XXX.....X.X.XX....XX......X..
X..XX.XX.XXX...XXXX.......X.......XXXX..XXX.....X..
X.....XX...X.X.........X.....XXX...X....XXX..X.....
..XX...XXX...X.....X.....X.X...XXX......XXXX..XX...
.....X......XX.XXX.XXXXXXX..X..X....X...XXXXX.....X
...X..X.....XX...X.....X....X.XX.X..XXX..X.....X..X
.X....X.XXXXX....XXXX..X......X..X.XXX...X.X...X.XX
...XX.X.....X.XXX.....XXXXXX.......X...X.....X.....
X..XX..X....X.....XXXXXXXX...X...XXX......XX.XX.XX.
.......X.X....XX...........XXX...XX.......XX....XX.
....XX...XXX.....XXX.....XXX.....X..X..............
XXX.....XXX..XXXXX.....X.....XX....XX..XXXX........
XX....X...X....X....XX....X..X..XXXXXX........X....
XX.X.........X....X.XXX...X....XX....XXX....XXX.X..
XX...X...X......X.X..XX.XX....XXX.XX.XX.....XXX.XXX
X......X....X...X.XX.XX.X..X...X.....X..X...X...XXX
X........XX...X...XX....X....X...X.....XXXX...XXXXX</walls>
			</board>