<?xml version='1.0' encoding='UTF-8'?>
<board>
				<level>146</level>
				<width>53</width>
				<height>51</height>
				<walls>XXX..X......X.....XXXX.....X....XX.........X..X......
XX...X.XXXX.......XXXX..XX.X.XX..X......XX....X..XXX.
...X....XX...X....XX..X..X...X...XX........XX..X.....
.XX...X....XXX..X.....XX....X..X.....X.........X..X..
.XX......XXX..X.....X...X.....X..X.X.X....X.....XXX..
.X....XX..XX..X..XX.....X.XX....X..X.XXX........X....
...XX...X.....XXX....X....XXXX..X....XXX...XXXX...XX.
XXXXXXX...XXX..XX.XX.....XXXX..X.....XXX...X......XX.
...........XXX........X....XX..X.....XX..XX..X....XX.
.......X.X.......X.X....XX..X...X...XXX.....XX.......
X...X....X..XXX....X.X....X...X.X.X.XX....XX...X.XX..
..X.X.X.XX......X.....XXX.XX......X....X..X..X.X.....
.XX.....XX.XXX....X.X..XX.XX..XX.X...XXX.X..XX.......
....XX.........XX.X.XX....XXX....X.X.......XX........
..X.XXXXX.X....XX.X.....XXX..X..XX........X......XXX.
XXX.......X....XX...X........X..XXXX....XX.....X.X...
XXXX.....XXX...XX...X........X..X.....X....X.......XX
...X.XXX.X...X.XX.....XXX.......X.X.X.....X.....X..XX
.X.....X.....X.....XX.........X.....XX......XXXX...XX
.X..X.....X......XX...XXXX.XX.XXXX...X..XX...X...X.XX
.X....XXX.....XX...........XX......X.XX......X..XX...
.X...XX....X..XX...X.X.....XXXX....X...X.....XX......
...X....XX....XXX..X.....X.X....X..XXX.X.XXX.....XXXX
XXXX.X..X..XX.....X...XX.X...X..X....X.........X..XXX
.....XXXX....X...XX....X.X..XX..XXX.....X.........X..
....XXX...XX...X....XX.X.X..XXXXXX..XXXX..X..XX......
X.....X...........X..X...X......X..XXXXX.XX......X...
X.XX.....XX...X...XX...XXX.X....X...........X......X.
..XX.X......X...XX.....XXX.X..XXXXX....XX.....XXX....
.X...X..X.X....X....X....X..X.......X....XXX...X..X..
...X..X.X....XXX..X.X.XX.XX....XXXX...X......X...XX..
......X...XX..X...X...XX.....X......XX..X........X...
.XXXX..XX.XXX...X..XXXXXXXX..X...X..XX......X......X.
.X...X..X...XX..XX..XX.......XX..X..X....XX...XXX....
...X....XX.......XX.......XX....X..X..XXX....XXXX...X
XXX......X.X.X...X....X......X..X....XX...XX......X..
....XXXX.X.X....X..X.......X.X....XX.....XXXX..XX.XX.
.X..X..X......X.X......X...X..XX.....X.X.......XX....
...XX.....X..XX.....X......XX....XXXXX....X..X.X...XX
......XXXXX..XX..X..X.X......XXX...X....X......X.X..X
....XX.......XXX....X....XXX.......X.XX.....X.......X
...........X..X..XX..X...X..X...X....XXXXXX.XXX...X..
......XXXX.XX...XXXX.....X..X.X...X.........XX..X....
..XX....X..X...X......X..X....X.....XXX..XXXXX.......
XXXX.XX...XX.X...X.......X...........XX......X...XXXX
X....XX..XXX.XX......X.........XXX...X..XXXX.X.......
....XXX....X......X.....X.XXX...XX.XXX...X...........
.X......X..XXX.X....XXX...X...X....XX..X......XXXXXXX
...X......XXXX.X.X....X..XX..X..X..XX...XXX....XXXXXX
..XX.X...X...X.X....X.X....X.X....XX..X......X..XXXXX
..XX...X...X...X..X...X....X...XX....XX..XXX....XXXXX</walls>
			</board>