<?xml version='1.0' encoding='UTF-8'?>
<board>
				<level>183</level>
				<width>64</width>
				<height>64</height>
				<walls>....X..XXX..X.......XXXXXXXX...X..XXXX....XX...X.....X..........
....X..XXX....XXXX......XXXX...X....XX.X..XX.X...XX..X.......X..
...XX......XXXXX...X.......X..XX.XX....X.XX..X......XX.......X.X
.X....XX.......X...X...X.X.X...X.XX..X......XX.....XX..X.....X.X
....X..X...XXX.......X.X.....X.X........X....X..X..XX......X...X
X...X..XX......XX.X....XX...XX........X......XXX..XX....X..XX..X
X.X....XX.X.X.....X.XXX...XXXX..XXX....XXXX......XX..XX...X..XXX
X.X.XX......X.X.........XXXXXXXXX...XX..X...X..XXXX.XXX..XX.....
X.......XX.........XXX...X.........XXXX.....X..X....XXXX....X...
...X.......X...........X.X....XX.X...X...X..X....XXXXXXX..XXX...
.......X.X.XXXXXXXXXXXXX..X......XX....X.X....X...X...XX........
XXX....X.X........X..X....X.XX.X....X......X....X...X.XX.....X..
..XXX....X........X..X......X..X.X...XX.X..XXX......X.XX..XX....
...X..X.........XXX....XXX..X....X.X....X.XXX..X......XXX..X..XX
.X...X..X...X.....X.X......X.....X..XX......X...XXXX.XX....X.XXX
.X.....XX...X..X....X.X.X....X...XX....X.X....X...XX.....X......
.X.XX..XX....X...XXXX...X.X.....XXXXX..X.X.X........XX.X......X.
..........XX......XXX......XX.X.XXX....X.....X...XX.XX....XXX...
..X.X...X.X.....X.X...XX.X....X...X......XX....X..X.......XXX..X
..X...X.X...XXX...X...X..X..XXXXX.XXXXX..X..XX....XXX.....XXXX..
..X..XX...............X......X..X.XX..X....XXX..X...X...X....XX.
..X.....XXXXXX............XX....X.......X...XXX.XXX.XXX......X..
....XXX.XXXX...XXXXXXXXX......X.XX...X....X.....XXX......X...X.X
.....XX..XX..XXXXX..X....X.XX...X..X...X.......XXX..XX.X...X.X.X
...X..XX..X...XXX...X.X....X...XX.XXX....X.............X...X...X
.X....XXX..XX.X...X..........X.......XX.......X....XX...........
....XX...X.X..X...XX...X.XX......X.X..XXX.XX..X..X....XXX...XXX.
X.XXX..X.....XX.....XX......XX.....XX.....X..XX....XXXXXXXX.....
..X...XXX.................XXXX..X......X....XX..XX.X.........X..
.X........XXXX.....X....X..XXXX...XX.....X...X.......X....XX....
...X...XX.XXX....XXX.XX....X..XX..XXXXX....X......XX....X.....X.
..XX.......XX.XX.....X..XX....XX.XX.....X..X..X...X...X...X.X...
...XXXXX.X....XX....XX.....XX.......XXX....X..X.X...X.......X...
.X....X..X..XXXXXX..XX...X...XX...XXX....X..X......X...X........
..X.....XX....XX...XXX.XX.....XXX......X..X....X.....X......XX..
X.X.XX...X....X....XX..X..X.X........X..X...XX.X....XXXXX...X..X
..X.X..X..X.....X..X..X..X..XXX..XXX.XX.....XX....XX....X..XX...
.XX.X.....X......XXX....XX.......X...XXX..........XX.XX..X....X.
.XX...X....X...X....XX......X..X...XXXXXXX...XXX.....X...X......
.XX.....XX...X....X..X...XX.X.....XXXXX....X........XX.........X
....XX..X...X.....XX...X......XXX.....X......XX.X.......X.......
XXXXXX........XX..XXX......X.XX....XX.....X..XX....X.X....X...X.
XXX....X...X........X.X....X..X..X..XX...........X...X.X....X...
XX..X......XXXX.....X..XX.....XX....XX..XX.XXX......X....XX.....
XX....X.....X...XXXXXX.XX...XXXX.....XX....X....X.X...X...X.XX..
.....X....X...X..X......X....XXX.....X...X....X.X.......X......X
.......X.....XX..X.XX.X....X..XXX......X....X.....XX.......X...X
....X....X.X.....X..X....X....XXX.XXX..XX.X...XX...X...X...X..XX
.XX.XXX..X.....X.XX.......XXXXX...XX...X..X......X...X...X..X...
......X..XX.XX.X.....XX.X.........XX...X.......X....X....XX.XXX.
XX.......XX..X....XX..X.X...XXXX..X...XXXXXX........X.X..X..X...
XX...X...X...X..X..XX.X...X....XXXX.X...........X.....X..X....XX
...X...XXX......XX..X..X...X...XXX..XXX....XXX............XX....
.......X....XXX..XX....X.X...XXXXX.......X.....X.XXXX..XX....XX.
XXX......X..XX...XX..X...XX..X.........X......XX..X....XX..XXX..
....X...X..XXX....X......X.....X..XXXXXXXX......X....X......XX.X
.XX...X...X.....X...X......XX.....X........X.......X...XXXX.....
..X.........XXX.XX....X...X...X...X...X...XXXX..........X.....X.
X....X.....XX...X..X......X.....X.XXX...X.........X...X...X.....
XX.X.....XXX....X....XXXX....X..X..XXX...X.....XX.XXX.......XXXX
...X..X......X..X...XX....XX.X.X...X...X.X..XX........XXXX......
.X........X....X..XX...X...X.....X.....X.XX...XX.X....X....XX...
.X.XXX.X....XX.X.......X.X.XX...XX.XX..X..XX.....X.X..X.XXXX....
...XXX...X.....XXXXXX..X...XXXX....XX..XX....X.....X..X......X..</walls>
			</board>