<?xml version='1.0' encoding='UTF-8'?>
<board>
				<level>182</level>
				<width>65</width>
				<height>63</height>
				<walls>...X..XXXXX........XXXXX.......X...XXX.....XX...XX......X....XX..
.X....X............X.........X...X.....XXX.XX.X....X....X.XX.....
....X....X.XXX.....X.XX.XX.........XXXX..X....XXX....X..X.XXXX...
....XX.X.X...X.X...X.X..XX.XX.XXXX.........X..X...X.....X.XXX....
...XXX.....X...X...X.X........XX....X...XX.XXX..XXX...X...XXX....
........X..XX..XXX...X....X.......X...X.XX.....XXXXX......XX.....
..X...X...XXXXXX...XXX.XX.X...X...X.XXX...X.....X....X.XX.XX.XXXX
XXX.X....XX....X.X...X.XX...X...X.....XXX...XXX.X..XXX.....X..XXX
.......X.XX......X.....X...XX....XXX.......XXXX..X.X...X.X.XX.X..
...X.....XX..XX.....X....X..X..X..X..X.........X.....X...X.XX....
....XX..XXX...XXX.X....XX...X..XX...XX.X..X.XX...XX...XX...X.....
..X..X......X...X....X.XX......XX....X.X....X.......X........XXXX
..XX.X...X...XX..X...X....XX...XX....X...XXX..X...X...X.....XX...
..XX...X...X..XX..XX....X..X....XXX..........XX...XX....X.XXXX...
XXXXX.....X...XXX.....XXXX...XX.....X.......XX..XXX..X..X.XX..X..
......X.X.X....XX......XXX....X....X....XXX.X..XX...XX....X...X..
.....X..X...XX.........X....X...XX...XXXXXX...XXX......XX...X....
.....X........XX.X...XX.....XX......XXXXXXXXXXXX.....XX.....XX...
....XXXX...XX.XX...X.X..X.X.......X...X.....XXX..X...XX.XX.....X.
..X......X......X..X...X..X.X...X.XXX....XX.....XXXX....XXXX.X...
.....X.....X.XX.......XX........X...XX.X.XX...XX.....X..XX...XXXX
.X.X....X..X.....XX.......XX.XX......X......X.XX.....X..X..XXXX..
...X..X...X....XX....XX...X..XX..X.X...XX......X........X.XXXX...
..XXX.XX....XXXXX..X....XXX...XX...XXX....XX.X...X......X......X.
XX.....X.....XXXXX.....XXX....X...X.....X....XX........X.........
X..X.X.XXXXX.X...XX....X...XX...X...X...X..XX.....X......XXXXXX..
X.XX...XXXX..X.X.XX.X....XX...XXXX....XXX..X........X...X....X...
..X...X..X..X....X....X............X....XXXX.X...X....XXX..X...X.
.XX.X.X..X.XX.X....X...XXX.....X......X.X......X...X...XXX....X..
....X.X....XX.XXX....X.XX....X........X.....X.XX.....X...XX.....X
XXX...X.X.......X...XX....XXXX.XX....X...XX.X..........X.X..XX.XX
......X...XX......XXXXXX..XX...XX......X.......XX...X..X...XXX...
..XX.....XXX.....X....X...X....X....X....X........X...X...X....X.
X..XXX.X..X....XXX....X.X...X..X......X..X....X.......X.X.X.X....
XX.....XX...XXXXXXX...X....X.........XXXX..X.....X......X...X.X.X
....X......XXXX.....X......X.XX........XX....XX....X.X...XX...X..
.XX....XXX......XX.....X..XX.XX.....X.....XXX...X....X.X.........
.....X...X...X.....XXX.....X.....X....XXXX......X............XXXX
..X........X.....X..XXX..X.....X...X.......XXX..X.......XXXX..XXX
XXX.....XXX...X.....X....X.........XXXX...XX...XX.XXXXX.......XXX
XXXX..X...X.X...X...X.XX...XXXXXX....XX.X....X....XX....XXX...X..
......X.X...XX......X.........XX..XX....XXXXXX..X......XXX..X....
...XX...XX..X....XXXXX....X......X........XXXX....X.XX...X.......
XX...X..XX..X.....XXXX.XX......X......XXX.XX...X....XXX..X...XXXX
..X..XXX......XXX.XX...X...X......X...XXX.XX.....X......XX.X.....
..X.XX...XXXX...X..X..X..X.XXXX...X..X..X..................X...X.
..X.X..XXXX......X..X.X.........X..X......X.....XX.....X...XX..X.
X...X....X.....X.XX.......XXX...XX..X.........XX.....X...X....XX.
.......X...X.........X.....XX.XX..X........X..X.......X..XXXXX...
.XXXXX...XX.....XX.......X....XX.........XXX..X.X...X.X....XX..XX
.........XX.X....X....X.......XX.......X......X.X.XX..XXX...X....
X.....X...X....X.X..X...X.....XXXXXXXX...XXXX...X....XXX..X......
XXX.....X....X.X.XXXX..X......XXX....XX..XXX...X....X..X.XX..XXXX
X....X...XX......X..XX...X...........X....X..X.X....X....XX...XXX
...X...X....X...X...X..XXX...XXX....X..X....XX.X...XX...XXX...XXX
.X.X.......XX...X.X...X....X......X...X..X.......X.XX....XXXX....
.X....XXXX...XX...XXXX..XX......X..XX...X...X...XX.....X....X....
....X..........X..XX...X...........X......X...XXXX..XX....X..X...
X...XXX..XX.XX...XXX......X...XX.....X.X...X...XXXXXXX..X.XX...X.
X.XXXXX...X.......X.....X...X.X....XX..X.X.X.X.XX...........X....
X...XX..X.X...X.X...XX..........XX..X....X.....XX.....XX.XX.XXX.X
X....X......X...X.......XX...X...XX...X.....X...X..XX..X.....XX..
X..X.....XXXX..XX.....X....X.....XXXX.....X.....X..XXX.....X.....</walls>
			</board>