<?xml version='1.0' encoding='UTF-8'?>
<board>
				<level>160</level>
				<width>57</width>
				<height>56</height>
				<walls>XX......XXXX.....XX.......X....X.....X...........X..X....
X..XX.....XX.....XX.XXX...X.X..X.XXX...XXXXX.....X....XX.
X......X...X...XXX..X.......X.X..X...........XX..X.....X.
.....X...X...X.XX..XX.XX......X.....XXX.....XX..X......X.
................X......X..XX......X.....X...XX....XXXX...
XXXXX...X.....X......X.X.....X.......X.........X........X
XX....X...XXX....X.....XXX.XXX..XXXX.....X.X.......XX.X.X
XX.X.....X.....X....X..X...XXXX.X.....X....X.XX.X..X..X.X
X..X...X....XX....X...XX....XXX...X.....X....X..X.XX....X
X...XX....X....XX.....X.....X..X....XXXXXXXXXX.......X...
....XX..XXX..X..XX......XXXX...X.X...............X.....X.
.....X..X.....X....X.........X.....X..........XXX.....X..
XXXX..X.......XX...XXXXXXXX..XX.X..X......X...XX..X.....X
......X.XX.......XXXXXXXXX..XXX.X.XX...X..XXX....X...X..X
.X......X...XXX....XXXX..X....X.X....X...XXX....XX.X..XXX
...XXX....X.....XX...XX....X....X.........X..X.....XX....
X....X...XX..X....X.....XXX..X..........X...X..X....XXXX.
X.X....X.....X..X.X.X.X...X.X....XXXX...XXXX..X..XX....X.
X...X....X...XX.X.....X.X.....XX......X.X....XX........X.
......X..XXX....XX.........X.........XX...X.....XX.......
..........X..X..XX..XX...X...XX.XX......XX..XX...........
XXXX......X....XXX...X...X......X...X...X..X...XX...X....
..XX.....XX.X..X...X...XXX........X....XX.........XX..X..
...X...X....X.XX....XXXXXX...........X...XXXX...X....XXXX
.X...X....XXX.X...X..XX...............X.......X...X....XX
....X......XX...X.XX......XXX.......X...X.X.......XXX..XX
X.....X....XXXXXX.X....XX...X.XXX...XX....X..X....XXX....
...X....X....X......XXX.......X...XXX..X...X...XXXXX..XX.
...XXX....XX.X...X.XX......XX.......X....X...........X...
..XX...XXX...X.....X..XX.X...............XX...X...XXXX..X
...X.X.X...XXX.......XX..X...X.......X......X...X.XXXXX.X
.X.X.....XXXXX.......X..XXXX...X...X...XX.....XXX..X....X
....X.X....XXX..XXXX.X.XX........X.....XXXXX....XX...X...
X.X...X.XX.X......X..X....X...XX.XXXX..XXXXX.XX....X...X.
X..X.......X....X...X..X..XXX..X......XXX....XXX...X.X...
...X.X.X...XXXX....XX..........XX.......X........XXX.....
.......X.X..XXXX......XXXX...X....XX....X.......X...X....
XXXXX....XX.X....XX....XXX.X...X.....X....XX........X.X..
..X...X..X..X.X..X.....XXX.XX....X.X...X...X...X.X.......
....X....X....X..X.XX......X..XX.X.......X.XXX...X..XX.X.
.XX....X.XXX..X..X.......XX..X.....XXXXXXX..XX..XXX..X...
.....X...X...X...XXX.X...X..XX.XX....XX.....XX....XX.....
XX.X.....X.X.X.X.XX..X..XX.....X..XX....XXX....XX.X...XX.
X..X..XX...X.X.X.XX...X....XX....X.......XX.X..XX...X..X.
X..............X....X..XX..X..X....XX..X......XX....XX...
..X...X...X.X...XXX....XX.XX........X....X....XX.XX...X..
....X...X.X.X.X..X...XX......XXXXXX...X........X..X......
...XXXXXX...X.XX...X....XX.XXXXX.....XX.X.X..X.XX....XXX.
.XX...X.........X..........XX....X.XXX....XXXX.....X...X.
....X...............XXXXX.....X..X.X...X.XX..XX......X...
XX.....X.........XXXX.....XX..X..X.....X.....XX.......X..
XX...X...XXX...XXXXX..XX.....XX..XX......XXX..XX....X...X
..XX....XX..XX...X...XXX.X...XX..XX...XX....X.X.....XXX..
..X...X.XX.....X.......X.....X...X....XXX.....X.X.X....X.
....XX..XX...X......X........X.X.X.....X.....X....X.XX...
.......XXX............X......X...XXXXX...X.....X....XXX..</walls>
			</board>