<?xml version='1.0' encoding='UTF-8'?>
<board>
				<level>145</level>
				<width>52</width>
				<height>51</height>
				<walls>..........XX..X..XXX.....X......X........XX..XX...XX
........X.X...X..XXX...X.X..XXX....X...X.....X..X..X
X.......X...X....XXXX..X..X....X.X...X.....X...XXX..
X....X..XX...X...XX...X...XX...X....XXX....XXXX...X.
XXXX.X..X....XXX.X..XX..XXXX......X...X...XXX...X...
XXX.......XX.....X.XXX...XX.....XXX...XXX.XXX.XXX..X
....X......X.X.........X....X...XXXX..X...XXX.X.....
..XX.....X.....XX.X.............XX....X..X..X...XXX.
X.X..XXX.XX.X..XX...X........XXXX..XX..X.X.....X....
X...XXX..XX....X..........XX..X...X....X.X...X...XXX
XX......X........XX..XXX..XXX.X...X..........XX...XX
XX...XXXX.........X..X...XXXX.X.........X.......X.XX
XXX.....XXX..XXXX........XXXX......X....X....X..X..X
....X.X...X....XXX....X..XXX.....XXX.XX....X...X...X
...XX..XX.X.XX........X....X......X..X..XX.X...X.X..
.....X..X...X..........XX.....XXX...XX.....X.....X..
........X..XX.XXXXXX.X....X...XX...XX..XX...........
....X...XX......XXX..X........X..X.XX.....X.........
..XXX.X.XX.X......X........X..X.........XX..XXXXXXXX
...XX.X....X........X...X..X......XX.......XXXXXXX..
.X..X.....X......X....XXX.XXXX........XX.XXX........
.XX.X..X..X......X.X...XX.........X.X..X...X....XXX.
..X.X..X.XXXXX.XXX...X.XX..X....X...XX.....XX...X...
X...X.....XXX..XXX...X..XX....X......X......X..X..XX
XXX.....X...X....X......X...X....XXX.X......XX...XXX
.....XXXX......X.X..X.....X.XXX....X..X.........XX..
...X.......X.....X......XXX.....X...X...XXXXXXX.....
......XXXX...XX.........X...XX..X.X.........X...X...
..XXX.....X.......X.......X....XX.X..XXX......X.....
...XXX......XX.........X.....X..X..X...X.X.....X....
...X....XX...X...XXX.....X...XX....X.X.....XXX...XX.
X.....X......XX.....XXX..X...XX.......X.....XXX.....
....X...........X.X...XXXX....X.....X..XX.X...XXX.XX
.X....XXXXXXXX....XXX.XXX.....XXXX...X....X....X..XX
...XX...X...X..X.X......X.X....XX..X.........X...XXX
XXXXX.....X.X..X.....X....X..X....XXX....X...X.....X
.......X....X.....XX...XXXXX.....X....XX...XXX.XXX.X
.......X......XXXX......XX....XX.X.....X....XX.....X
........X..X.........XX.....X..........X.XX.XX..XX..
...X..X....X......X....XXXX.....X.XXX.....X.XX...X..
.....X.....XXX..X.XXX...XX...XX.X.....X.X.X....X....
..X....XX.......X.XX..X....XX......X..X.....X.......
X...X.XXX..XXXX...XX.XX..X.....X.X....XX........XXXX
X.XXX....X.......XXX...XX..X.X...XX...X....XXXXX....
X........XX...XX.XX..X.XX.XX....XXX..XX.X...XX...XX.
...XXXXXX...X..X.XX..X........X..XXX..X...X......X..
.X........XXXX...XX....X...XX.XX..XXX.....XXX....X.X
....X....X....X..X..X....X.....XX..X......XXX....X..
..X...XX...X....XX.XX.X......X.XXX.X.XXXXXXXXXX..XX.
XXX....X..XX.X...X..X...XXXXXX..XX....XX...XXX....X.
XXX....X..XX...X....X..XXXXXXXX.....X....X.....XX...</walls>
			</board>