<?xml version='1.0' encoding='UTF-8'?>
<board>
				<level>199</level>
				<width>70</width>
				<height>69</height>
				<walls>X..X....XXXXXXXX..X.....XX.......X......X....X..X...XXXX..XXX......XXX
X..X....X...XXXX....X......X.......X....X..X....X.X...X...X........X..
X..X...XX.....X..X.......X......X.....XXXX..X...X...X...X......X...X..
X....X.XX..X....XX...X........X.....X.....X..XX.X....X..XX...XX..X....
X.......X....XX.......XXX...X..X.....X....XX..X....X.XXXXXXX....XXX...
......X...X...X.....X....XX......XXX.....XXXX....X.......XX..X....X...
....X..X....X.XX..XXXX.....X....XXX...XX.......X..X.X....XX....X......
..X....X...XX.....XXXX..X....X...XX....X.....X..X...X.X..XX...XX.X.XXX
....XX.....XX...X..XXXX...X....X.......X...X..X..XX......X..XX.....X..
.XX.....X.....X..X.....X..X.X...XX.....X.XXXX....XX.XX.....X...XX.....
..X..XX...X....X.X...X....X.....XX...X.........XX...XXXXX.........X...
X.X..........X...X......X....XXX.....XXXX.........XX.....XX...X.......
..X...XXXX.X...XXX..X.X.X..X..X..........X......XXXX........X......XXX
........X..X.....X....X.X...X...X...XX.....X..........X.....XXXX.XX...
XX...X....XX..XX...XXXX...X..X....X....XX.X..X...XX.....X..XXXX..XX.X.
...XXX.X...X..X.....XXX..XXX.XXX....X..XX.X....X.....XX.X.....X.X.....
....XX...X.XX....XX.XXXXX......XXX...XXXX...X......X......XXX.X...XX.X
XXX..XXX...X...X.XX..XX...X.XX..XX.X.....XX...X......X......X....X...X
X....XXX.....X.....X......X...X....XXX...XX...XXX.X.....XXX.XX.....X..
X.....X..XX....XX...........X..X.........X........X.X.X..XX.....X.....
..XXX...XXX.X.....XXXXX..XX.XX.X....XXX....X.XXX....X..X......X.......
..XXXX......X.X....X.....XX.X..X..X.....X.XX.....X..XX....X......XXXXX
....XXXX.XXX..XXXX...X...X..X.X....X....X....XX....XX...X.....XX..XX..
.X.......X...XXXXXX....X...X..X.XX.....XXXXX..XXX..X..XX...X......XX..
.X.X.XX......X....X......XXX........XX.XX...X......X.....X...X........
.X...XX.X....X.XX.....XX.X.....X.......XX...XX.........XXXX....XXXX...
..XX....XXX..X..X..X...X...XX.........XXX..X....X...X.......XX.X...XX.
X..X...XXXX..XX......X.X....X.X...XXX...X.....X...XXX.X......X...X....
...X..............XXXX...XX...X...XXX.....X...XX...........X.........X
......X....XXXX...X.....XXXX....XXXXX..XX...X........X.XXX....X......X
XXX.XX............X.......XXXX....XXX..XXXX.......X..X........X.XXX..X
....X..X.......X..X..X.......XXXX.X.......XX........X.....X...X..XXXXX
.XXXX.X....X.....XX....X...X......X.X...X....XXXXX....XXX...X.XX......
.XXX..X.XXXX..X...X.X..X.X....XXXXX...X.XXX..X.....XXXXXXX..X.XX..XXX.
.....XX.....X...X.X...X..X.XX...XXXX....XX...X.X....XXX.....X..XX.....
XXX..X...XX.XXXX..XX....XX...XX......X..XX...X....X.X...XX..XX......XX
..XXXX.X.XX...XX.X...X........XXXXX....XX..XX...X.X....XXX....XX.X..XX
..XXX..X...XX....X........X.X..X....X..XX...X.....XX.X...X.....X...XXX
......XX.....XX.....X...X...XX...X....XX..X..........X.....X.X........
.X...........X..X...X...XX...XX....X.....XXX.......XX...XX.X.X..XXXXX.
.X.....XX......XX.XX..X....X....X..X...XXX...XX..X....X.X....X........
..XX...XX.....X....X....X....X.......X.X......X......X..X.X.....XX...X
X.XX..XXX...XXX..X......XXX...XX.XXX.X...XX.X.X.X......XX.....X....X.X
X..XX.....XXXXX..X......X...X.XX..X..XX..X..X...X...X..........XX..X..
XX.X...XX........X.XX..XX......XX.X.XX..XX...XXXXXX..........X.X...XX.
...X.X........XX...XX..X.....X..X...XX.....X..XX...........X.X...X....
.XXX.....XX........XX....XXXXXX..X..XX...X.XX.X..X.....XXX...XX...XX..
......XXXXX.XX.XX.....XXXX....XX.......X......X.XXXX.X.X....XXX.X.....
....X...X......XX.X.X......XX.X...XXXX...XX..........X...X..XX..X..XX.
.XX..XX...XX.XX...X........X..X.X...XX..XX.....XXX..XXX..X.XX..X...XX.
..XX.X....X..X.......XXX...X.XX.XXX.XXX....XXXX.....XX...X.XX....X..X.
X..X...X....XX.X.X.........X....XXX....X...XX.....X....X...X..X..XX...
XX....XX.X.......X..X..XX.......XXXXXX...X.....X.......XX..X..XXXXXX..
X...X.........X...X.X.....X.......X...X..XXXXX...X.XXX....XX..........
..XX..X...X.......X.X.X...X....X....X....XXXXXX..X...XX...X..XXXX...X.
...X.X..X...XX........X.....XX...X..X..X.....X...XXX........X.....X.X.
XX...X....XX.......X.....XX.........X.....XX...X.....X...X.....XXXX...
..X....X.....XXX...X..XX....X....XX...X...XX..XXX........X.X.X.......X
....X..X...X.....X.XX......XXXX....XXXX...XX........X......X..........
.X..X....X...XXXXX.X...XXX.XX...XX....X....X.....X..XXXXX..XX.......X.
...X..X......XXX...X.X.....X..XX....X......XXXX....XXXXXX.......X...X.
..XX.XX...X....X.....X....XX.XX.....X.......X....XXX........XXX...X...
.....XXXX...XX.XXXX....X..XX.XX.X.X...XXXXX.X..X.....X...XXXXXX.XX....
.XXXXX.....X...X....XXXX.XXX.X....X.....XXX....XX......X....X......XX.
...XXX..XX.X..X..X.......XX..X.X.....X.....XXX..X...X.....X...XX......
XX...XX..X..X.X.........XX..X....XXX...X...X....XX......X..X..XXX.....
.....XXX..X.......XXX...X..X..X....XX..X..X..XX....X.X...X.X......X...
.XX...XXX.XX...X...X....X....X..XX.....X....XX..X..X.X.X.....XXX......
....X.....XXXX...X...X..XXX..X.........X.......XX..X...XX........XXX..</walls>
			</board>